> Agisci come un traduttore specializzato. Il tuo compito consiste nel creare una frase utilizzando le parole indicate in dialetto sorianese con annesso significato in italiano, per farlo bisogna utilizzare **esclusivamente le risorse fornite**: un **dizionario terminologico** e una **raccolta di esempi poetici/testuali**.
>
> Per ciascuna frase, restituisci **unicamente** un oggetto JSON con questa struttura:
>
> ```json
> {"translation": "testo tradotto qui"}
> ```
>
> ### Regole da seguire con assoluta precisione:
> 1. **Utilizza solo i termini e le espressioni presenti nel dizionario e negli esempi**, senza introdurre neologismi o interpretazioni personali.
> 2. **Mantieni inalterato il significato, il tono e lo stile** del annesso significato annesso in italiano originale.
> 3. **Non fornire spiegazioni, note, commenti o testo aggiuntivo** al di fuori dell'oggetto JSON richiesto.
> 4. **Rispondi esclusivamente con l'oggetto JSON** avente la sola chiave `"translation"`.
> 5. Se una parola non è presente nel dizionario, cerca di parafrasarla (o usare sinonimi) usando termini **documentati** negli esempi testuali.
> 6. Modifica la forma della frase se necessario, per adattarla alla sintassi e alla morfologia della lingua in questione.
>
> Hai a disposizione:
> - Un dizionario dettagliato di termini dialettali/locali.
> - Esempi di poesie e racconti in lingua tradotta, da usare come riferimento stilistico.
>
> **Esempio operativo**:
>
> - Input:
> ```
> I cookie sono piccole porzioni di dati che vengono memorizzate e utilizzate per migliorare l’esperienza di utilizzo di un sito.
> Ad esempio possono ricordare temporaneamente le tue preferenze di navigazione per evitarti di selezionare tutte le volte la lingua, rendendo quindi le visite successive più comode e intuitive.
> Oppure possono servire per fare dei “sondaggi anonimi” su come gli utenti navigano attraverso il sito, in modo da poterlo poi migliorare partendo da dati reali.
> Se si desidera disabilitare l’uso dei cookie è necessario personalizzare le impostazioni del proprio computer impostando la cancellazione di tutti i cookie o attivando un messaggio di avviso quando i cookie vengono memorizzati. Per procedere senza modificare l’applicazione dei cookie è sufficiente continuare con la navigazione.
> I cookie sono dati salvati in forma testuale nella forma “variabile=valore” (esempio: “dataAccessoSito=2014-01-20,14:23:15″). Questi dati possono essere letti solamente dal sito che li ha generati, e in molti casi hanno una data di scadenza, oltre la quale il browser li cancellerà automaticamente.
> Non tutti i cookie vengono utilizzati per lo stesso scopo: di seguito verranno specificate le diverse tipologie di cookie utilizzati da questo sito web.
> Questi cookie sono essenziali al fine di consentire di spostarsi in tutto il sito ed utilizzare a pieno le sue caratteristiche. Senza questi cookie alcuni servizi non potranno funzionare correttamente.
> Questi cookie raccolgono informazioni su come gli utenti utilizzano un sito web, ma non memorizzano informazioni che identificano un visitatore. Questi cookie vengono utilizzati solo per migliorare il funzionamento del sito web.
> Utilizzando il sito l’utente accetta che tali cookie possono essere memorizzati sul proprio dispositivo.
> I cookie consentono al sito di ricordare le scelte fatte dall’utente (come la lingua o altre impostazioni speciali eventualmente disponibili) e forniscono funzionalità avanzate personalizzate, e possono anche essere utilizzati per fornire i servizi richiesti. Utilizzando il sito l’utente accetta che tali cookie possono essere memorizzati sul proprio dispositivo.
> Il consenso per l’utilizzo dei vari cookie tecnici elencati s’intende accordato anche in modo implicito se l’utente prosegue la sua navigazione su questo sito web come anche i cookie di statistica.
> La maggior parte dei browser accetta automaticamente i cookie, ma l’utente può modificare le impostazioni per disabilitare tale funzione. È possibile bloccare tutte le tipologie di cookie, oppure accettare di riceverne soltanto alcuni e disabilitarne altri. La sezione “Opzioni” o “Preferenze” nel menu del browser permettono di evitare di ricevere cookie o altre tecnologie di tracciamento utente e come ottenere notifica dal browser dell’attivazione di queste tecnologie.
> Ricordiamo però che la disabilitazione dei cookie tecnici potrebbe limitare la possibilità di usare questo sito web e impedire di beneficiare in pieno delle funzionalità e dei servizi presenti.
> Provvedimento del Garante per la Privacy dell’8 maggio 2014, pubblicato sulla Gazzetta Ufficiale n. 126 del 3 giugno consultabile all’indirizzo: www.garanteprivacy.it
> ```
> - Output:
> ```json
> {"translation": "I cookie so' piccole porzioni de dati che s'arimano e s'usanno pe' fà mejo l'esperienza de usà 'n sito. Pe' esempio, ponno aricordà pe' 'n po' le preferenze tue de navigà, evitanno de scegne ogni vorda la lingua, facenno le visite appresso più comode. O pure ponno servì pe' fà 'domande senza nomi' su comme la ggente naviga, pe' migliurà 'sto sito partenno da dati veri. Si te vole disabbilità l'uso de li cookie, te tocca personalizzà le impostazioni d'u computer tojo, mettenno de scancellà tutti li cookie o attivà 'n messaggio quanno se mettono. Pe' seguità senza cangià nente, basta seguità a navigà. Li cookie so' dati salvati in forma testuale comme 'variabbile=valore' (tipo 'dataAccessoSito=2014-01-20,14:23:15'). Ste dati ponno leggerli solo 'sto sito che l'ha fatti, e spesso c'hanno 'na data de scadenza, doppo che 'l browser li scancella da sé. Nun tutti li cookie servono pe' lo stesso scopo: ccqua sotto se spiegano le varie sorte. Sti cookie so' necessari pe' poté navigà dappertutto e usà tutte le funzioni. Senza, certi servizi nun fonzionano. Sti cookie ariccojono info su comme la ggente usa 'sto sito, ma nun registrano nomi. Serveno solo pe' migliurà 'l sito. Usannolo, l'utente accetta che ste cookie se mettino. Li cookie permettono ar sito de aricordà le scelte tue (lingua o impostazioni) e danno funzioni personalizzate. Usannolo, l'utente accetta. 'U consenso pe' li cookie tecnici se dà automatico si te seguiti a navigà, pure pe' quelli de statistica. A majjà parte de li browser accetta li cookie da sé, ma te poi cangià le impostazioni pe' disabbilitalli. Te blocchi tutti o solo certi. Nelle 'opzioni' o 'preferenze' d'u browser trovi comme fà. Ma attento: disabbilità li cookie tecnici te po' limità l'uso d'sto sito e nun te lassa godé tutte le funzioni. Provvedimento d'u Garante pe' la Privacy d'u 8 maggio 2014, pubbrecato sulla Gazzetta Ufficiale n. 126 d'u 3 giugno, leggetelo a 'www.garanteprivacy.it'."}
> ```

DIZIONARIO:

```
A BEA! : A bere! (Quasi a dire: ti ho impressionato, ti sei spaventato. Bevi che ti passa la paura).
A PO' : Ormai. (A po' che ce semo = dal momento che chi siamo); anche DA PO'.
ABBADA' : Badare, custodire, accudire (es. abbadà la casa, i ffijo).
ABBASTA' : Bastare; (ABBASTA TUSSI' = così è sufficiente) (Jì dovrebbe abbastà = Gli dovrebbe bastare).
ABBATELLO : Chierichetto.
ABBIOCCO : Attimo di sonnolenza, stanchezza.
ABBISA' : Avvisare; ABBISORNO = avvisarono.
ABBOCCATO : Dicesi di vino né dolce, né secco.
ABBOZZA' : Sopportare malvolentieri.
ABBRACCICATI : Abbracciati.
ABBREO! : Tirchio!
ABBRUCIA' : Bruciare.
ACCA' : Qua; anche CCA'.
ACCAJO' : Quaggiù.
ACCARAVUJASSE : Azzuffarsi.
ACCASARE : Abitare (do' s'ito accasato? = dove sei andato ad abitare?).
ACCASSU' - ACCASSUNE : Quassù.
ACCAVARGA' : Cavalcare o accavallare.
ACCENNA : Accendere (ACCIGNIVA = Accendeva).
ACCHIAPPARELLA : Gioco di ragazzi che si rincorrono.
ACCHIESA : Chiesa.
ACCIANCA' : Stringere tra le gambe (dare l'ACCIANCO = fare una corte spietata).
ACCIDEFA (ACCITEFA) : Accipicchia.
ACCIOCCASSE : Accosciarsi, avvilirsi, piegarsi sui talloni.
ACCIRIGNASSE : Impazzire, intristirsi.
ACCIRIGNATA : Coccolata. (es. donna che si lascia avvolgere in un abbraccio protettivo).
ACCOZZICASSE : Appisolarsi; ACCOZZICATO = appisolato.
ACCUNNI' – ACCUNNÌTO : Condire, condito.
ACCURTA' : Accorciare.
ACCUSSI' : Così, in questo modo (anche ATTUSSI' - CUSSI' - TUSSI').
ACCUTTIMATO : Lavoratore indefesso (Stakanovista).
ACQUETTA : Brodaglia contenente i rimasugli della porchetta (v. anche PIATTELLA).
ADDANNA' : Dannare.
AFFIARASSE : Avventarsi (S'AFFIARETTE - AFFIARATO = Si avventò – avventato).
AGGHIANNASSE : Sdraiarsi, accomodarsi (come può fare una maiale sulle ghiande).
AGGUAJASSE : Sdraiarsi, avvilirsi - AGGUAJATO = s'è buttato giù – AGGUAJITE = coricati.
AIUTANE : Aiutare (T'ajo d'aiutane? No faccio da mine = Ti devo aiutare? No, faccio da me).
AJO : Aglio (pronuncia identica alla voce "ho" - eppure te l'ajo ditto = eppure te l'ho detto).
ALA E GOBBA : Gioco che i bambini facevano con le figurine.
ALENTE : Ecco fatto, così impari.
ALL'ANIMA : Accidenti.
ALLECCONÌSSE : Invogliarsi, svegliare l'appetito. ALLECCONITO = invogliato.
ALLEGA' : Astringere l'epidermide della bocca (Me s'alleghino i'llenti = mi si legano i denti).
ALLEGREZZE : Doni per sposalizi, nascite.
ALLESSO : Lesso, bollito (ill'allesso).
ALLOCA’ : Sistemare, trovar posto (l’hai allocato i’ppranzo? = hai digerito il pranzo?).
ALLUCCASSE : Stancarsi. ALLUCCATO (LUCCO) = stanco finito – (anche ALLACCASSE).
ALLICCIA’ : Camminare a passo spedito; sbrigarsi.
ALLUMA' : Adocchiare, guardare sott'occhi, aguzzare la vista (ALLUMATO = incantato).
ALLUPATO : Eccitato (sessualmente) v. anche ARRAPATO.
AMANDULI : Mandorle (generalmente fresche).
AMERICANA : Frattazzo, grande spatola per intonaci (v. anche SFRATAZZO).
AMMANNATO : Guasto (di frutta).
AMMANTA' : Avvolgersi, vestire.
AMMASONA' - 'MMASONA' : Intridere, maneggiare l'impasto per il pane - fare l'AMMASONATA.
AMMÀTTISE : Imbattersi.
AMMAZZA – AMMAPPA : Accipicchia, Accidenti. (Ammazza so' stracco – Ammappite si' bbella; Accidenti come sono stanco – Accipicchia come sei bella).
AMMEREJA' – AMMEREJASSE : Dicesi di pecore o altri animali fermi sotto il sole, come se dormissero.
AMMOCCA' : Imboccare.
AMMONTA' : Salire (a cavallo).
AMMUMINTI : A momenti, quasi (ammuminti gnavo jò = stavo quasi per cadere).
AMORE AMORE : Metodo di cottura, molto lentamente.
AMPICCIA' – AMPICCIASSE : Interessarsi dei fatti altrui, ingombrare (Scanzite che m'ampicci = Levati che mi dai fastidio).
AMPICCIONE : Curioso, pettegolo.
ANCLUPPASSE : Ripararsi dal freddo.
ANCO' : Ancora.
ANCURICCHIA' – ANCURICCHIASSE : Piegarsi, chinarsi sui talloni, rattrappirsi (ANCURICCHIATO = Accovacciato, rattrappito).
ANDÈNNA - ANTÈNNA : Capire, intendere (Nun andinnia = Non capiva).
ANDRO - ARTRO – ADDRO : Altro. (C'è aremasso addro? Nissun andro? = C'è rimasto nient'altro? Nessun altro?).
ANFÓNNISE - ANFUSO : Bagnarsi, bagnato. (v. anche INFONNA o 'NFONNA).
ANGUATTA' : Nascondere (v. 'NGUATTA' o INGUATTA'). I' ffiji giochino a 'nguattarella = I bambini giocano a nascondino.
ANGUATTARELLA : Nascondino (I' ffiji giochino a 'nguattarella = I bambini giocano a nascondino).
ANGUMINGIA : Comincia, inizia.
ANGUMINGIA' - ANCUMINGIA' : Iniziare (N'arengumingiassi = Non ricominciare).
ANISO : Anice.
ANISTRELLO : Rastrello.
ANNA' : Andare (v. anche 'NA - GNA' - JI').
ANNANZI : Avanti (tir'annanzi = tira avanti).
ANNARELLO : Girello per bambini.
ANNO : Anno. Senza articolo significa l'anno scorso (es. ce so' ito anno = ci sono andato l'anno passato).
ANTIRICHI’ : Rattrappire; ANTIRICHITO = rattrappito.
ANTRALUCCA’ : Barcollare; essere instabili (vedi 'NTRALUCCA').
ANTRAPPAJA' – ANTRAPPAJATO : Confondere, confuso (v. INTRAPPAJASSE – 'NTRAPPAJA').
ANTRUPPATO : Urtato, intruppato.
ANTUSA' - ANTUSO – ANTUSATO : Ammaccare, ammaccato (anche INTUSATO – 'NTUSO).
APISE : Matita, lapis.
APPALLOZZASSE – APPALLOZZATO : Avvinghiarsi, ridurre a palla, colluttarsi.
APPANICATO : Malaticcio, pallido.
APPARA’ : porgere qualcosa, anche affrontare, metterci un rimedio (comme l'appari la faccenna?).
APPARECCHIO : Aeroplano.
APPENA : Rattrista.
APPIANA' : Salire (per le scale, in auto).
APPICCAPANNI : Appendi abiti.
APPICCA' : Appendere, accendere. (Hajo appiccato la giubba = ho appeso la giacca - ete appiccato i' ffoco = avete acceso il fuoco).
APPICCHITE! : Arrangiati!
APPICCIA' : Accendere.
APPICCIUME : Ramoscelli, carta e foglie secche che si usano per accendere il fuoco.
APPINICASSE – APPINICATO : Addormentarsi, insonnolito.
APPIZZA' : Assaggiare con la punta della lingua, aguzzare (Appizz'i'll'occhj = Aguzza la vista).
APPIZZUTA APISE : Tempera matite.
APPIZZUTA' : Fare la punta a qualcosa (Nu' l'appizzutassi = Non lo fare troppo appuntito).
APPÓLLO : Il rientro serale di galline e uccelli al nido.
APPOZZA' : Intingere.
APPUSCHIJA : Sinonimo di alta temperatura (ajo 'n callo che appuschjo = ho un caldo che soffoco).
ARA : Aia per battere il grano.
ARADIO : Radioricevitore (pronunciato sempre con l'articolo: la radio = ILL'ARADIO).
ARBIRI PIZZUTI : Cimitero.
ARBOLETO : Arboreto.
ARCHEMUSE : Alchermes.
AREBBOLLA : Ribollire. (J'arebbulliva i'zzangue - Gli ribolliva il sangue).
ARECCONTA' : Raccontare (t'arecconto = ti racconto).
ARECCÒTA – ARECCÒSSO : Raccogliere - raccolto.
ARECORDASSE : Ricordare.
AREDDUSSE – AREDDUTO : Ridursi - Radunato (il raccolto).
AREECCO - ARIECCO : Di nuovo, ci risiamo.
AREFUCINA' : Rovistare (v. anche AREMUCINA' o SMUCINA').
AREMANE' - AREMASSO - AREMANETTE : Rimanere, rimasto, rimase.
AREMBARZA' : Rimbalzare.
AREMEDIA' : Rimediare.
AREMICIDA' : Ripararsi (dalla pioggia).
AREMUCINA' - ARIMUCINA' : Rovistare, cercare, rimuginare. (anche AREFUCINA' o SMUCINA').
ARENGRESCIA : Rincrescere.
ARENVISCIDA' - ARENVICIDA' : Resuscitare.
AREPARBASSE - REPARBASSE : Non osare, aver timore.
ARESCALLASSE : Adirarsi.
ARESCERNA : Vedere, distinguere, aguzzare la vista.
AREVIA - ARIVIA : Di nuovo, ancora.
ARICCOMANNO (M'_) : Raccomando (ariccomannite di'zzignore = raccomandati a Dio).
ARIECCHITELLO : Rieccolo, eccolo nuovamente.
ARIGNIGNOLASSE : Riprendersi, ringalluzzirsi.
ARIVURDICA' : Rivoltare (S'ARIVURDICHETTE = si rivoltò).
ARRAPATO : Eccitato (sessualmente) v. anche ALLUPATO.
ARRAZZICARE: Stuzzicare, provocare (di solito un cane).
ARRI CCA' : Vieni qua (comando usato per indirizzare gli equini).
ARRI LLA' : Vai là (comando usato per indirizzare gli equini).
ARRICCASSE : Arricchirsi.
ARRUCATO : Rauco.
ARVA : Le fico arva (tipo di fico).
ARZICA' - ARRAZZICA' : Tirare calci (di somari, ecc.). (Anche di persona che reagisce).
ASSÈA : Ora, adesso.
ASSOGNA - ASSUGNA : Sugna, grasso.
ATTANFA’ : Dare cattivo odore es “T’attanfa la surcica – ti puzza l’ascella
ATTUMELLA' : Mettere, buttare in un angolo.
ATTUMELLATO : Gettato in un angolo, dimenticato.
ATTURA' : Tappare.
ATTUSSI' : Così, in questo modo (anche ACCUSSI’ - CUSSI' - TUSSI').
AZZECCA' - AZZECCHIME : Azzeccare, colpire nel segno. Colpiscimi.
AZZICA' - AZZICO (dare ill'_) : Dare il via, stimolare.
BADANAO : Gran sedere (anche, più genericamente, cosa grossa).
BACCAJA' : Litigare (se so' baccajati = hanno litigato).
BACCHIO : Bastone a testa grossa.
BANNA : Fanfara, banda, anche nel senso di gruppo (v. anche MUSICA), fetore.
BANNELLA : Serramento fissato sul lato esterno delle ante di porte e finestre.
BANNITA : Bandita, terreno recintato (BESTIE A BANNITA = animali al pascolo). Più genericamente zona di protezione dove alcune attività vengono bandite:
BANNOLO : Bandolo.
BARBACANE : Supporti in pietra dei travi dei camini, alari.
BARBACCIA : Rutto forte e rumoroso.
BARBOZZO : Mento.
BARLOZZO - BARLOZZETTO : Barile, barilotto.
BAROZZA : Carro da buoi.
BARZINELLA : Cosa né buone né cattiva.
BARZOTTO : Dicesi di frutto, cibo, animale, né maturo né acerbo, né cotto né crudo. Anche di uomo né ragazzo né adulto o di organo sessuale maschile non completamente eretto.
BASSIFRATTA (fare la _) : Ripulire un bosco dalla vegetazione infestante.
BASSO : Avvallamento, passo o valico.
BATIZZO : Battesimo.
BATOCCHIO : Battaglio delle campane, dei bussaporta.
BATTILONTO : Tavola battilardo.
BATTIMURO : Gioco che i bambini facevano con le monete.
BEA - BII - BEETTE - BIUTO : Bere, bevi, bevve, bevuto - (i'bbea = il vino) da cui il detto bii bii i'bbea bà = bevi bevi il vino papà.
BEARELLO : Prodotto alimentare. Riveniente dalla lavorazione delle interiora del maiale.
BECALINO : Orbo, strabico; genericamente detto di chi vede poco.
BECCAMORTO : Infame, becchino (v. anche CASSAMORTARO).
BEFANÌA : Epifania.
BENANCHE : Nonostante, anche sé.
BIASTIMA : Bestemmia (v. anche DIASILLA).
BIASTIMA' : Bestemmiare (D'ill'acchiesa nun ze pole biastima' = In chiesa non si può bestemmiare).
BIBBIRIBBOZZA : Gioco per bambini, simile al saltamontone.
BICCUTO : Curioso, impiccione.
BIFERA : Tromba, nasone.
BIFERETTA : Trombetta.
BILANCIONE : Grande bilancia appesa ad un'asta, normalmente retta sulle spalle da due persone, usata dal quintale in su.
BILLO : Tacchino.
BIOCCA : Chioccia.
BIRBACCIONE : Birbante, furbacchione.
BIRBO : Svelto, pronto.
BIROCCIO - BIROCCINO : Carretto, carro a cavalli per il trasporto di 1 o 2 persone.
BITTINA : Recipiente per olio (anche VETTINA).
BOCCATONE : Schiaffo a mano aperta sulla bocca.
BOCCIA - BOCCIONE : Bottiglia - Bottiglione, fiasco.
BOCCO : Moneta, soldo. (anche MOCCO).
BOLLETTA : Chiodo corto a testa larga (veniva infisso sulla suola delle scarpe per rallentarne l'usura).
BONA MORTE : Confraternita religiosa in saio nero.
BONO : Capace, (si bbono tu? = tu sei capace?); anche piacevole (me sa bono = mi piace).
BÔO : Bue.
BOTTAFONE : Fondo di un crepaccio dove si raccoglie l'acqua caduta dall'alto. Punto più ampio e profondo dei fossi dove sipossono trovare i gamberi d'acqua dolce.
BOTTINO : Serbatoio in muratura, generalmente prossimo ad una sorgente, per la raccolta di acqua potabile.
BRAGHETTONE : Listello di legno.
BRATICOLA : Graticola.
BRILLOCCHI : Brillanti, gioielli (v. anche SBRILLOCCHI).
BRISCHIO : Vischio.
BRONZETTO : Piccolo mastello in legno di forma ellittica con manico, utilizzato in genere per l'asporto di vino dai tini.
BRUGNOLO : Fungo commestibile con cappello di colore bruno.
BUCIARDA : Attrezzo edile con punta sulle due estremità.
BUCO : Vicolo (oltre alle altre accezioni).
BUSSI : Colpi, rumori.
BUTTITO : Luogo ove venivano vuotati i vasi da notte (v. PITALE).
BUZZICO : Oliatore; gioco per bambini detto "ACCHIAPPARELLA".
CACAPRUSSIA : Disinfestante per piante, anche pianta selvatica avente qualità astringenti o diarroiche a seconda del senso delle foglie.
CACARITTO : Sgabello con un solo piede, usato dagli scalpellini.
CACCAVELLA : Bacca rossa di siepe selvatica.
CACCHIARA : Bosco di castagno rinascente dal tronco di alberi tagliati. Bosco di polloni; dim. CACCHIARETTA.
CACCHIO : Gemma di vite o pollone.
CACCIA’ : Riuscire (nun ce la caccio = non ci riesco).
CACCIO : Estraggo (caccio i' vvino = prendo il vino dalla botte), faccio (nun ce la caccio = non ce la faccio) (v. anche CAVO).
CACIARA : Confusione.
CAE' - CAETTE - CAÙTO : Cadere - cadde.
CAÉTTA - GAÉTTA : Compagni di persone poco di buono.
CAGNANTE : Fungo del genere "boleto" che cambia di colore al taglio; tossico crudo. (detto anche di persone voltagabbana).
CAJ : Calli.
CALLAFREDDA : Effetto nocivo sulle colture che produce poca pioggia su terreno caldo.
CALLAJA : Caldaia (grossa pentola per fare il sapone).
CALLARA : a tutta callara = di gran corsa.
CALLARO : Recipiente per cucinare o scaldare acqua.
CALLARELLA-O : Piccolo recipiente da cucina o secchio da muratore.
CALLAROZZO : vedi CALLARO.
CAMPA ANCO'? : E' ancora vivo? (v. anche E’ MORTO MMAI?).
CAMPA’ : Vivere.
CAMPANO : Grosso sonaglio (al collo di animali).
CANA : Cagna.
CANALE - CANALETTO : Grosso cucchiaio in legno per prendere farine o cereali.
CANIPINA : Appezzamento di terreno molto piccolo, orticello.
CANIZZA : Discussione animata e rumorosa, litigio.
CANNELLA : Cavola per botti.
CANNOCCIO : Sbocco di uscita dei liquidi.
CANUCCIO : Cagnolino.
CAPAGNO : Paniere con manico.
CAPA' : Scegliere, mondare (ete capato i ccici? = avete pulito i ceci?).
CAPÈRCHIO : Telaio per la tessitura della canapa (esiste anche un Vicolo del Caperchio, in prossimità dell'ingresso al Castello).
CAPEZZA : Cavezza, corda con cui si lega l'asino.
CAPILLI : Capelli (l'ajo preso p'i'ccapilli = l'ho preso per i capelli).
CAPO : Testa, chi è al comando di qualcosa.
CAPOCCIONE : Testardo, zuccone, (v. anche zuccarotto).
CAPOCCIUNI : Girini.
CAPOCOLLO : Lonza.
CAPOFOCO : Alare del camino.
CAPOMAZZO : Parte iniziale dell'intestino dell'agnello, utilizzata nella cottura della "Coratella d'abbacchio".
CAPPANNELLO - CAPANNELLO : Persona col naso grosso "a capanna".
CAPRARECCIA : Ricovero per capre.
CARABOZZOLO : Bambino vivace.
CARAPIJA : Parapiglia.
CARATELLO : Recipiente per vino.
CARAVUJA' : Scompigliare, sconvolgere (v. anche SCARAVUJA').
CARBONARA : Carbonaia; catasta di legna, ricoperta di terra, che si bruciava per poi ottenere carbone.
CARCALLASINO : Quasi un suggerimento per il contadino che all'Ave Maria doveva caricare il somaro e rientrare che era giunta l'"OR DE NOTTE".
CARCASELLO : Mucchietto di nòccioli di pesche fatto per gioco dai bambini.
CARCATOJA : Paletto per sostenere su un lato la soma.
CARCATOJATE : Bastonate (con la carcatoja).
CARGA' : Caricare.
CARGE o CARCE : Calce.
CARNAJOLO : Che lavora le carni (la vecchia "di'ccarnaiolo" che viveva "rento un seccatoro").
CARRARECCIA : Strada sterrata carrabile.
CARREJA' : Trasportare.
CARRETTELLA : Veicolo composto di 4 tavole, 2 assi e 3 cuscinetti a sfera con cui i ragazzi si catapultavano nelle discese. Si manovrava con una corda e si frenava con i tacchi. Le fratture erano frequenti.
CARRIERA : Corsa rapida (de carriera = in modo veloce).
CARRUCOLE : Occhiali.
CARTARENA : Costola.
CARUSINO : Barbiere.
CARZAROTTO : Calzettone.
CARZUNI : Calzoni.
CASSAMORTARO : Becchino (v. anche BECCAMORTO).
CASTALLO : Messo del Tribunale o della Curia.
CATANA : Borsa, cartella con manici. Usato anche per definire un capo d'abbigliamento eccessivamente abbondante (te sta comme 'na catana).
CATARCIONE : Pesante catenaccio.
CATELLO : Catenaccio.
CATERATTA : Botola.
CATERVA : Grande quantità.
CATOLLO : Sputo grasso (di secrezione).
CATTANNO : Rovina (S'ito a'ccattanno = Sono andato in rovina).
CAVACICI o CAVARCICI : Cavalcioni.
CAVO : Faccio, riesco (ce la cavo da solo = ci riesco da me) (v. anche CACCIO).
CAZZAROLA : Casseruola.
CAZZIMPERIO : Salpepolio (condimento).
CCA' : Qua. (veni a ccà = vieni qua).
CE LL'ETE? : Ce lo avete?
CEPA : Cipolla.
CEPPA : Mortaio in legno.
CEPPAJA : Tronco d'albero reciso, che ha prodotto nuovi getti.
CEPRO : Dispari (v. anche SCEPRO).
CERASA : Ciliegie.
CERQUA : Quercia.
CERQUETO : Querceto.
CERVIO - CERVIOTTO : Acerbo - Non del tutto maturo.
CETRUNI : Cetrioli.
CHÉ - CAÉ - CUTO - CAUTO : Cadere - Caduto.
CHÈ? - CHENE'? : Che? - Che cosa?
CHECCOSA - CHECCOSETTA : Qualcosa. Qualche cosetta.
CHI’ : Con il, di chi.
CHI SSI’ FFIJO? : Di chi sei figlio? come si chiamano i tuoi?
CHIAPPAPETE : Incapace, inconcludente.
CHIEMPA - JEMPA : Riempire (Jimpito = Riempito).
CHIOCCHIA’ : Pigolare (cantare di pennuto).
CHIOÉLLO : Perno che blocca il giogo dei buoi al carro.
CHIÒO : Chiodo.
CHITUNO : Qualcuno.
CHITUNANTRO - CHITUNANDRO : Qualcun altro.
CHIU' : Più.
CHJÈA : Chiedere (Chjìva, chjeètte = chiedeva, chiese).
CHJÈLLI : Nessuno ('n c'è chjelli = non c'è nessuno).
CIANCA - CIANCHI : Gamba, gambe.
CIANCHETTA : Sgambetto.
CIANFANAIO : Parolaio, imbroglione.
CICA : Affatto, mica (nun l'ajo visto cica = non l'ho veduto affatto).
CICAROLO : Colui che raccoglie le cicche (di sigaretta) gettate.
CICCIA’ : Germogliare.
CIFOLETTO : Fischietto.
CIFOLO : Ciufolo o zufolo. In modo figurato "ha mesto i' cifolo = ha messo il broncio".
CIFOLOTTI : Rigatoncini, pasta corta rigata.
CIFOLOTTO : Stupido, incapace.
CINICE : Residui del focolare ancora accesi.
CINQUALE : Schiaffone con le dita aperte.
CINTURINO : Cinta dei pantaloni (m'ajo da levane i' ccinturino? = devo minacciarti con la cinta dei pantaloni?).
CIPICCIA – CIPICCIOSO : Secrezione sierosa degli occhi; cisposo.
CIPIGNOLO : Salvadanaio. In modo figurato testa dura (che c'hai rento i cipignolo? = che ti dice la testa?).
CIRIGNA - CERIGNA : Grosso canestro con due manici (v. anche MINELLA).
CIUCCO : Brillo.
CIUCO : Piccolo.
CIUÍTTA : Civetta.
CÓA : Coda.
COACCIO : Covo, tana.
COAGNIGNOLO : Il più piccolo di una nidiata o di una famiglia.
COARIZZO : Fondoschiena del pollo.
COATA : Riposata, amalgamata, insaporita. Detto, ad esempio, di una minestra mangiata il giorno dopo la cottura (la magnamo ddimane, intanto se coa; perchè coata jè più bbona).
COCIA - COCE : Far male; me fa cocia = mi fa male.
COETTA : Misura di farina.
COJONARE : Canzonare.
COMMANNA! : Grido della fornaia di primo mattino, con cui invitava le massaie a portare il pane a cuocere. (Quasi a dire: sono pronta, accetto ordini.)
COMMATTA : Affaccendarsi.
COMME : Come. (E comme? = In che modo? Come sarebbe?).
CONCIARELLO : Setaccio utilizzato in edilizia per selezionare la sabbia.
CORBO (v. anche GORBO) : Accidente. Che te pija 'n corbo = Che ti venga un accidente.
CORGASSE : Coricarsi. Te corgo = Te ne do' tante da coricarti.
COROJO : Cercine. Panno raccolto a ciambella sulla testa per il trasporto di un carico (ha fatt'i'ccorojio, c'ha mesto la tiella e è ita a 'nfornà).
CORRIERA : Autobus (vedi POSTALE).
CORTELLETTA : Coltello per scannare animali.
CORVATTA : Cravatta.
CORVELLO : Setaccio per legumi.
COTOZZO : Nuca, parte posteriore del collo.
COSTA : Salita ripida.
COSTA COSTA : Modo di camminare al margine di una strada o di un terreno. (v. anche MURO MURO).
CRABIGNERE : Carabiniere.
CRAPA : Capra; a volte utilizzato per indicare anche la testa.
CRASCIA : Benessere, abbondanza, ricca dispensa.
CRATASTA : Catasta.
CREDENZONE : Grosso mobile da dispensa.
CRETTO : Crepaccio, fessura.
CRISTIANO : Persona, gente.
CROGGNOLA : Frutto del corniolo (indica anche un colpo violento ricevuto).
CROGGNOLATA : Bastonata.
CROGGNOLO : Corniolo, albero.
CROMPATO : Comprato.
CRUCOLO : Mazza di tamburo, fungo. Lat. Lepiota procera.
CRUTEGNOLO : Bitorzolo, bernoccolo, gonfiore in genere.
CUCCHIARA : Paletta usata dagli operai edili.
CUCCUMELLO - CUPPITELLO : Pentolino.
CUJA : Scroto.
CUJA LENTA : Chi usa pantaloni grandi e un po’ calati.
CULETTA : Cunetta stradale (v. anche PROVA e FORMA); usato anche per definire una donna chiacchierona, che parla continuamente.
CUMBINA’ : Mettersi d'accordo.
CUNFINO : Confine.
CUNICCHIO : Cunicolo (pl. CUNICCHIA) esiste un fosso detto "delle Cunicchia", per gli ingrottamenti dell'acqua.
CUPERTOJA : Coperchio di recipienti in coccio.
CUPO : Profondo, scuro (di luce).
CURIATO : Grosso bastone, a due segmenti, per battere legumi.
CURIOLI : Strisce di cuoio utilizzate normalmente come lacci per le scarpe.
CURRA : Correre.
CURRENTI : Centogambe, insetti pelosi.
CURTELLO : Coltello.
CUSSI’ (TUSSI’) : Così, in questo modo (anche ACCUSSI' - ATTUSSI').
CUTICA : Cotenna. Anche rispondendo a una persona permalosa (e che t'ajo ditto cutica? = e che t'avrò mai detto?).
CUTO A BAFFANNANZI : Caduto di faccia.
CUTO A CAPOTEFICCO : Caduto a gambe all'aria.
DA ESSO - DA ISSI : A lui, a loro.
DA MMI' - DA MMINE : A me.
DA PO' (A PO') : Ormai (Da po' che ce semo = dal momento che chi siamo).
DA TTI' : A te.
DA QUANTANE : Da quanto tempo.
DANARA : Seme di denari (nel gioco delle carte).
DEDECCA' - DEDECCANE : Di qua.
DEDICCHI' – DEDICCHINE : Di qui.
DEDISTI' : Lì.
DENANZI : Davanti.
DERETO : Didietro.
DI’ : Nel, sul (Di’pponte = sul ponte; di’ccasale = nel casolare).
DIASILLA : Bestemmia (V. anche BIASTIMA).
DIASCOLE : Diamine.
DICCHI : Qui.
DICIA : Dire, raccontare (che nun ze pozzi jì dicenno = che non si vada a raccontare).
DILLI' : Lì.
DIMANE : Domani.
DISCORRA : Discutere, colloquiare.
DISPARA' : Sparigliare.
DO' MMAI : Quando mai. (do' mmai s'ava da sapé 'na cosa ttussì = quando mai si doveva scoprire una cosa del genere).
DO NE VELLE : Da nessuna parte, in nessun posto.
DORGE : Dolce.
DOTTRINA : Catechismo.
DRENTO : Dentro (v. anche RENTO o RENDO).
DU' - DUI : Due.
DU'MMENTRE : Nel mentre, mentre.
DU'MMEZZO - TU'MMEZZO : Nel mezzo, nel mentre.
DUNCA : Dunque.
E’ MORTO MMAI? : E’ ancora vivo? (v. anche CAMPA ANCO'?)
ECCHEDECHE' : Ecco che.
ECCHIME : Eccomi.
ECCO : Guarda, vedi (guarda chi ecco = guarda chi sta arrivando).
EJELA : Eccola (v. anche ESSELA - ESTELA).
ENTI : Denti, es. me s'alleghin'ill'enti = mi si legano i denti (per frutta acerba, che allappa).
EPRE : Lepre.
ERGE : Elce (pianta) - (Sott'i'llerge de Sant'Utizzio = Sotto l'elce di Sant'Eutizio).
ERIMA - ERINO : Eravamo, erano.
ERTA - JERTA : Ripida (di salita).
ERTO - JERTO : Spesso, grossolano, maleducato (Si jerto comm'ill'orlo 'i ddomo = Sei talmente grossolano da essere spesso come la base del duomo).
ESSA : Essere.
ESSELO : Eccolo lì (v. anche EJELO - ESTELO).
ESTELA : Eccola (v. anche EJELA - ESSELA).
ETO - ETA : Dito - dita (v. anche LETO - LETA). Un eto = un po' (v. anche FRICCIOLO, OGNA).
ETONE : Alluce.
FA' I'FFIUME : Andar bene.
FACCENNA : Prestazione sessuale.
FACEMO : Facciamo.
FACETE : Fate.
FACIOLI : Fagioli.
FACIOLI DE LE CURDI : Fagiolini bianchi.
FAE : Fave.
FALLACCIANO : Fico; anche uomo meschino.
FAO : Faggio (fai buji = punto fitto e cupo della faggeta).
FARGE : Falce.
FARINELLO : Piccolo fungo bianco, commestibile.
FERCETO : Luogo invaso da felci.
FERRAIOLO (farajolo) : Cappotto. Più precisamente un’abbondante mantella, senza maniche e bottoni.
FI' : Figlio; es. curri fì = corri ragazzo, dattela a gambe.
FIACCAJNE : Debolezza.
FIARA : Fiamma.
FICO PICCIALONE : Varietà di fichi con il gambo; fico, al plurale "le fico".
FIEZZA : Ciocca di capelli (generalmente se di colore diverso).
FIJANO : Figlioccio (di battesimo, cresima).
FIJARELLO : Ragazzino.
FIJO : Figlio.
FIJOTTO : Figlio piccolo di animale, pulcino.
FILAGNA : Filare.
FILARELLO : Strumento in legno per filare la canapa.
FILO FILONZA : Tipo di farfalla.
FIMMINA : Donna.
FINENTE : Fino a (s'ito a piej finente i'pponte = sono arrivato a piedi fino al ponte).
FINI' : Finire (Finiscette = Finì).
FIOCCA' : Nevicare (Fiocca = Nevica).
FIOTTA’ : Lamentarsi, essere lagnosi.
FIOTTO : Lamento
FIRGI : Felci. (I' ffirgi = le felci).
FISCOLI : Filtri per l’olio usati nei frantoi.
FO' : Campicello, campagna - E' ito fò (o de fò) = E' andato in campagna.
FOCORE : Bruciore.
FOJETTA : Unità di misura del vino tipica delle osterie, equivalente a 1/2 litro.
FONNARDO - FONNO : Profondo.
FONTANILE : Abbeveratoio.
FORA - DE FORA - DAFORA : Fuori.
FORASACCO : Spiga selvatica che si trova in mezzo al fieno (v. anche PUGNASACCO).
FORCOLA : Insetto della frutta, forcina (ce so' le forcole rento le persiche).
FORDA : Bacino di raccolta delle acque.
FORGO : Palmo (come misura), tanto, parecchio.
FORMA : Avvallamento di terreno (specialmente al lato di strade e viottoli.
FRA AGGIUSTITE E METTITE BENE… : Tra una cosa e l'altra (fra aggiustite e mettite bene, ce vorrà 'n'antra oretta = per prepararmi ci vorrà ancora un'ora).
FRACIO : Fradicio (sia bagnato che troppo maturo).
FRANCIOTTOLA o FRANGIOTTOLA : Favola, bugia. (franciottola d’illume stento = storiella che va troppo per le lunghe).
FRANGETOLE : Erba selvatica a ciuffi (commestibile).
FRASCARELLI : Tipo di pasta fatta in casa.
FRASCHINO o FRESCHINO : Odore caratteristico di prosciutto non bene conservato per cattiva salagione.
FRATTA : Siepe, per di più spinosa, anche per segnare il limite dei campi.
FRÈE : Febbre.
FREGHINO o FRIGHINO : Commerciante troppo disinvolto.
FREGNA : Vagina.
FREGNACCIA : Stupidaggine; anche frittata di acqua, sale e farina altrimenti detta "SUTRINA".
FREGNO : Qualcuno, qualcosa (dispregiativo).
FRENGICA o FRENCICA o FREGNA o FRESCA : Accipicchia.
FRESCHE o FREGNE : Arrabbiature, avere le fresche o fregne = essere arrabbiato, inquieto.
FREZZA : Fionda a elastici.
FRICCIULI - SFRIZZOLI - SFRICCIOLI : Ciccioli.
FRICCIOLO - FRICCIOLETTO : Piccola quantità, , un po', un pochetto (v. anche ETO, OGNA, 'NTICCHIA).
FRILLICHICCHIA : Pioviggina (v. PIUJCCICA).
FRONTINO : Schiaffetto sulla fronte.
FUGATO : Chi va di fretta, veloce (de fugato = di corsa).
FUMOGENA : Malattia degli olivi.
FURCINA : Forcone, forca (attrezzo agricolo).
FURCINELLA : Forcella per capelli.
FURMINE : Fulmine, sinonimo anche di velocità (je 'n furmine).
FURMINA' : Bruciare (la lampadina s'è furminata).
FURMINANTI : Fiammiferi da cucina (sturare i furminanti = accendere i fiammiferi).
FUSCELLA : Recipiente di confezionamento della ricotta. Ill’arecotta vene comme la fuscella; spesso usato per giustificare i figli che hanno gli stessi vizi dei padri.
GAETTA : Gruppo di giovinastri.
GALITTI : Garretti, caviglie (L'ajo preso p'i'ggalitti = L'ho preso per le caviglie).
GANASSE : Mascelle, denti molari.
GARAVINA o CARAVINA : Attrezzo edile, piccone a punta e taglio.
GARGARIZZI : Gargarismi (v. anche GRAGALIZZI).
GARGAROZZO : Trachea (v. anche GRAGALOZZO).
GATTAROLA : Foro in basso alle porte per fare passare il gatto.
GATTÍO : Cattivo.
GATTO PUZZOLO : Puzzola.
GERZO : Gelso.
GHIACCULI : Scarti, cose superflue, impicci (v. anche STRUFFAJE e ZARAVATTULI).
GHIENORO : Genero (v. anche NORO).
GHIOTTA : Teglia rettangolare a bordo basso.
GIALLUNI : Genere di fagioli.
GIONCATA : Derivato del latte, ottenuto dalla separazione del siero dal coagulo, commestibile.
GIOVENNOTTA/O : Nubile, scapolo.
GIRELLI : Fuochi d'artificio.
GIUBBA : Giacca.
GIUBBA AREVORDATA : Di persona che ricicla vecchi abiti, non potendo permettersene di nuovi.
'GNA : Bisogna.
GNA' - GNATO - GNAMO : Andare, andato, andiamo (v. ANNA' - JI' - 'NA').
GNAOLA’ : Miagolare (anche SGNAOLA').
GNASTICARE : Masticare.
GNAULÍO : Miagolio.
GNERTO : Spesso, grossolano; (v. anche JERTO).
GNESPOLI - GNESPULI : Nespole.
GNESPOLO : Albero di nespole.
GNESTOLO : Fionda che si ruota per il lancio (non come quella ad elastici detta "MAZZAFIONDA").
'GNI POCH'E TTANTO : Ogni tanto.
'GNI SEMPRE : Sempre, ogni volta.
GNOMMARATORA : Donna che lavora la lana, materassaia.
GNOMMERO : Gomitolo di lana.
GNUCCO : Brillo.
GNUCCHITTI CH'I' FERRO : Tipo di pasta fatta in casa con acqua e farina.
GOGOSSO : Osso di pesca, (giocare a GOGOSSI e fare il CARCASELLO (v.) divertimento per bambini).
GOJAROTTO : Mattacchione, eccessivamente estroverso, plateale.
GOJO : Matto o anche guasto (es. per un prodotto vegetale).
GONDOLA : Traliccio appeso sotto i carri per trasportare fieno e pastura.
GORBE : Volpe.
GORBO : Colpo apoplettico, accidente (che te pozza pijà 'n gorbo = che ti venga un accidenti - Uguale a CÓRBO (v.).
GOVERNA' : Accudire, nutrire gli animali.
GRAGALIZZI : Gargarismi (v. anche GARGARIZZI).
GRACALOZZO : Trachea (v. anche GARGAROZZO).
GRASCIA : Termine di origine medievale che indica l’insieme delle componenti necessarie alla composizione del vitto.
GRAVIOLI : Dolci tipici del carnevale, ripieni di ricotta condita.
GRAZZIA : Grazia, benevolenza (troppa Grazzia Sant'Antò).
GRICCIORE : Tristezza, sconforto.
GRUGNO : Faccia.
GUADAMBIO : Guadagno.
GUAZZERA : Rugiada.
GUINZA : Terreno bagnato e pantanoso.
IAMMANCO o IMMENO : Almeno.
IEPPE : Zolle di terreno, rivoltate dall'aratro.
IMMASCIATA : Messaggio, ambasceria.
IMMOTTATORO : Imbuto (v. MOTTATORO).
INCANNATA - ANCANNATA : Trappola per invischiare volatili.
INCIAMPICA' : Inciampare (v. 'NCIAMPICA').
INCIURCINATO : Raggomitolato, raggrinzito (vedi anche ‘NCRIPPILLITO).
INCRIPPILLITO : Intorpidito (nei muscoli), rattrappito (v anche 'NCRIPPILLITO).
INCUJATO o INCUJATTO : Implume, imberbe.
INFONNA - INFUSO : Bagnare - Bagnato (v. anche ANFONNISE o 'NFONNA).
INFRANCUJATO : Frammischiato, confuso (v. anche 'NFRANCUJATO).
INGONIA : Agonia.
INGRUGNATO : Che tiene il broncio.
INGUATTA' : Nascondere (v. anche ANGUATTA' o 'NGUATTA').
INNIMICO : Nemico (Ill'innimico = Il nemico).
INTIGNA’ : Insistere, intestardirsi, (anche 'NTIGNA').
INTIRICHITO : Disseccato, intirizzito. Rimanere sbalordito, sorpreso (v. 'NTIRICHITO).
INTRAPPAJASSE - INTRAPPAJATO : Confondersi - Confuso (v. anche ANTRAPPAJA' - 'NTRAPPAJATO).
INTRONATO : Intontito, incrinato (in senso figurato: stupido, minato nella salute) (v. 'NTRONATO).
INTRUJASSE : Sporcarsi (v. 'NTRUJASSE).
INTURCINATO : Intrecciato, aggrovigliato (v. 'NTURCINATO).
INTUSATO : Ammaccato (anche ANTUSO o 'NTUSO).
IRRE ORRE : Scivolare sull'argomento, come LIPPE LAPPE.
ISSI : Avere (N'issi pura = Non aver paura).
ITO : Andato; (S’ito fo' = Sono andato in campagna).
J'E' : E'.
JERTA (ERTA) : Ripida.
JERTO : Spesso, grossolano; (v. anche GNERTO).
JI : Andare. (Tocca ji fo' = Bisogna andare in campagna; pres. io vajo; part. pass. esso gnava; pass. rem. nui gnemma) (v. anche ANNA' - GNA' - NA').
JI PUZZA I’ BBENESTA’ : Pretenzioso, che non si accontenta.
JI FA PROVE : Gli fa bene.
JI FETA PURE I' GGALLO : Ha una fortuna sfacciata.
JICINA : Decina.
JO' : Giù (scigni jò = scendi giù).
JOPPECCHI' : Giù per di qua.
JOPPEDISTI' : Laggiù da quelle parti.
JOPPELLI' : Giù per di lì.
LAI : Via, dai. (e lai... = e via..., e dai…) - (lai mpò piantela = dai smettila).
LAJO' : Laggiù.
LAJOPPEDEDILLI' : Laggiù in quel posto.
LAMPA' : Lampeggiare. (Si dicchì lampa de che parte trona = Se qui lampeggia in qualche posto tuona).
LANZAGNA : Pasta fatta in casa, lasagna.
LANZAGNOLO : Mattarello.
LAPPE : In qualche (ajo da passà 'ncò lappe che bottega = devo ancora passare in qualche negozio).
LA'PPE'CCHI' : Da queste parti.
LAPPEDOGNA : Emozione, paura, debolezza (v. anche PATUNIA).
LA'PP'ELLI' : Da quelle parti.
LARDELLO : Piccolo fungo commestibile di colore arancio (lat. Cantharellus cibarius).
LASCA : Fungo, a forma di lingua, che cresce sui tronchi degli alberi (lat. Fistulina hepatica).
LATTONZOLO : Maialino da latte (al forno).
LE COSE FATTE CON FINFIRINFIN SE NE VANNO CON FINFIRINFAN : Ciò che si ottiene con facilità, altrettanto facilmente si perde.
LEGA : Piccolo invaso d'acqua, prossimo ad una sorgente, delimitato da sassi disposti a secco e terra (es. LEGA della PALLUCCOLA).
LEMME LEMME : Piano piano.
LENA : Legna da ardere (pl. LE LÉNA o anche 'E LÉNA).
LETE : Levati, spostati.
LETO - LETA : Dito - dita (v. anche ETO - ETA).
LETTA : Striscia di terreno coltivabile limitato da due filari di alberi o di piante.
LIECIO : Insipido, acquoso, insapore (anche SLECIO).
LINTERNA : Lampada ad olio.
LINTIERA : Ringhiera.
LIPPE LAPPE : Scivolare sull'argomento, tergiversare, v. IRRE ORRE.
LO POZZO VEDE' COMME I' FFUME DILL'OCCHI : E' insopportabile, come il fumo negli occhi.
LOCCA : Chioccia.
LOCO COMMODO : Gabinetto.
LOFFA : Vescia (fungo); anche emissione silenziosa di gas intestinali (all'opposto di "SCURREJA").
LONTO : Lardo.
LORDO : Sporcaccione.
LOTO : Sudiciume, sporcizia, (v. anche OTO).
LOTOSO : Sudicio, sporco.
LUCCHISINA : Sovraccoperta di cotone o imbottita.
LUCCICA - LUCCICHETTA : Lucciola.
LUCCICORE : Bagliore.
LUCCO : Stanco (v. ALLUCCASSE).
LUCERNARO : Abbaino.
LUCIARO : Persona addetta alla lettura dei consumi e distribuzione delle bollette della vecchia Società Romana per l'Energia Elettrica.
LUFFO : Fianco (es. comme me cocino i lluffi = come mi fa male la schiena).
LUPO PENARO : Licantropo.
LUPINO : Specie di callo alle dita dei piedi.
LUPOLI : Getti primaverili di piante (es. vitalba). Commestibili.
LUSTRORE : Chiarore, splendore.
LUVI' : Guarda un po'? (Luvì chi ecco? = guarda un po' chi arriva?).
MA' - MATE : Madre, mamma (mate mia quanto patiscio = mamma mia quanto si soffre).
MACHINE : Madia (v. anche MATTERA).
MACIO : Strafatto, troppo maturo, molliccio, guasto (in senso figurato persona furbastra es. sì macio ma pperò).
MADONNÉLLE : Acheni, ancora verdi, di olmo, teneri e commestibili; anche bambine in costume nero e col velo, che accompagnano la processione del venerdì santo.
MAGGIO : Ginestra. (Hanno piantato 'i maggio = Hanno fatto sesso).
MAGNA' : Mangiare (i' mmagnà o i' ddamagnà = il cibo).
MAGNARDO : Famelico, mangiatore, di buon appetito.
MAGNASBOTTO : Biscia d’acqua.
MALE E PPEGGIO : Piccolo attrezzo da muratore con due punte da taglio perpendicolari tra loro (una taglia male e l'altra peggio).
MAMMANCO : Neanche, nemmeno (v. NIMMANCO).
MAMMOCCIO : Bamboccio, stupido.
MANCECOLA : Attrezzo per la lavorazione della canapa.
MANCIOCCOLA : Mano grande, grassa, capiente.
MANEJA' : Maneggiare, mischiare, muovere (Maneja maneja nun ajo capito chiù quelle = A forza di mischiare non ho capito più niente).
MANNOLO : Straccio per pulire il forno.
MANTENGOLA : Mattarello (v. anche LANSAGNOLO).
MARCHESE : Mestruo.
MARTAJATO : Malfatto (v. MARTUFO).
MARTINICCHIA : Freno a mano dei carri.
MARTUFO : Malfatto (v. MARTAJATO).
MARVEJA : Verme che si riproduce vicino all'osso del prosciutto male conservato (perché poco salato o fatto con tempo umido e caldo).
MARZI - MARZITTI : Cime di rapa.
MASTELLO : Recipiente con manico da inserire nelle botti per prendere un po' del contenuto.
MATRIA : "Madre" dell'aceto.
MATRIÀLE : Rozzo (di persona), materiale.
MATTA : Dal Vocabolo arcaico che indica una stuoia .
MATTERA : Madia (v. anche MACHINE).
MAZZAFEGHETE : Salsicce di fegato.
MAZZAFIONDA : Fionda ad elastici.
'MBORZO : Bolso, fiacco.
'MBRIACO : Ubriaco (stato momentaneo).
'MBRIACONE : Etilista (dedito al bere).
'MBROJO - 'MBROJONE : Imbroglio - imbroglione.
ME CE SCORZO TUTTO : Non ho alcuna fretta (quasi a farlo di proposito, come reazione).
ME SA MIJANNI : Non vedo l'ora.
MEJO : Meglio, migliore (sì' i'mmejo = sei il migliore).
MELLA : Mela (pl. le mella).
MELLAFRICA : Corbezzolo (frutto a maturazione invernale).
MENCELLA : Brocca di coccio per acqua.
MENCIO - MENCIAROTTO : Poco scaltro, sempliciotto.
MESCOLA : Cucchiaio in legno da cucina.
MESSA PAZZA : Messa pomeridiana del venerdì santo.
MESTO : Messo. (l'ajo mesto = l'ho messo).
META : Mietere.
METTA - MITTI : Mettere, metti (Nun ce mittissi becco = Non impicciarti).
MEZZA : Recipiente cilindrico per misurare cereali, olive, ecc..
MEZZADI' : Mezzogiorno.
MEZZAROLO : Mezzadro.
MICCIA : Asina.
MICIA : Gatta.
MIJARA : Migliaia.
MILLUZZA : Piccole mele, anche un po' acerbe.
MINELLA : Grosso cesto in vimini, largo e basso senza manici (con i manici è la CIRIGNA).
MINTURZELLA : Erba aromatica (usata nella cottura della trippa).
MINZONA' : Nominare.
MITTI A TOMBOLA? : Scegli i numeri? (da inserire nella cartella per partecipare alla tombola pubblica).
MO' : Ora, adesso.
MO’ MMO’ : Proprio adesso (so’ rentato mo’ mmo’ = sono rientrato proprio adesso).
MOCCO : Moneta, soldo (v. BOCCO).
MOCCOLO : Muco, moccio, secrezione nasale.
MOCCOLOTTO : Cerotto, lume. Usato nelle chiese o al cimitero.
MOCOLA : Lenticchia (legume); usato per indicare anche le lentiggini (mocoloso = lentigginoso) dal lat. "macula".
MOGNA : Mungere.
MONNA' : Pulire, mondare.
MONNEZZA : Immondizia.
MONNEZZARO : Spazzino; cumulo di rifiuti.
MONNOLO : Scopetta o panno usati per pulire i forni a legna.
MONTONE : Tanto/i (c'ha un montone de bocchi testo stì = è molto ricca quella persona lì).
MORDACCHIA : Museruola.
MÓRDO : Molto.
MORRALE : Palo in legno (generalmente usato nei sottotetti).
MORRE - MORRALE - MORRALETTO : Scarpata.
MORTAJOLO : Porcino (fungo) Boletus edulis.
MOSCIARELLE : Castagne secche.
MOSCIO : Flaccido (di frutta e di persona).
MOSTRARELLA : Atto dello strofinare la buccia dell'anguria sulla faccia.
MOTTATOIO - MOTTATORO : Imbuto, che imbotta (anche IMMOTTATORE).
MOVA : Muovere (Mujva = Muoveva).
'MPOPONITO : Intontito (dopo un colpo ricevuto), insonnolito (appena sveglio).
MUCCICOSO : Moccioso, .
MUCCI' : Scappare, fuggire, uscire di casa. (J'è toccato muccì - E' dovuto scappare).
MUFFA' : Ammuffire (anche ammuffà ill'occhi = fare gli occhi neri con i pugni).
MUNELLACCIO : Ragazzo dispettoso.
MUNELLO/A : Bambino/a.
MURO MURO : Modo di camminare accanto ai muri, quasi a ripararsi sotto la gronda (v. anche COSTA COSTA).
MUSETTA : Sacchetti di mangime appesi al collo di animali.
MUSICA : Banda.
MUSICANTE : Componente di una banda.
MUTA’ : Cambiare.
MUTATA : Cambio di vestito per le feste (es. la mutata della Domenica).
NA' : Andare (v. anche ANNA' - GNA' - JI').
'NA MASSA : Tanto, molto, infinitamente.
NATICA' : Tentennare, smuoversi (es. il sasso naticarello o rupe tremante).
NATICCHIA : Nottolino in legno per chiudere infissi.
'NCIAMPICA' : Inciampare (v. INCIAMPICA').
'NCIANCICA' - 'NCIANCICATO : Masticare, sgualcire - masticato, sgualcito.
'NCIURCINATO : Raggomitolato, avviluppato; (v INCIURCINATO).
'NCOLLA' : Prendere in braccio (fijarè te pijo ‘ncollo? = ragazzino, ti prendo in braccio?).
'NCRIPPILLITO : Intorpidito (nei muscoli), raggrinzito (vedi anche INCRIPPILLITO).
NE' TENÉ NE' SCURTICA' : Non accontentarsi, non accettare compromessi.
NESCA - NESCHE : Botta - botte solenni.
NESCO : Boccino (v. anche ONNESCO).
'NFRACICASSE : Bagnarsi, infradiciarsi.
'NFRANCUJATO : Mischiato, confuso (v. anche INFRANCUJATO).
'NFRATANDO : Frattanto.
'NFONNA - 'NFUSO : Bagnare - Bagnato (v. anche ANFONNISE o INFONNA).
'NGO' : Ancora.
'NGRAVIDA' : Mettere incinta.
‘NGRUGNATO : Arrabbiato, offeso.
'NGUATTA' - 'NGUATTATO : Nascondere, nascosto (v. anche ANGUATTARE o INGUATTARE).
'NGUATTARELLA : Nascondino (gioco per bambini).
‘NGUJATTO : Spogliato, detto di volatile implume.
NICULIZIA : Liquirizia.
NIMMANCO : Neanche (v. MAMMANCO).
'NNASPO - ONNASPO : Raspo d'uva, grappolo.
NOCCHIA : Nocciola.
NOCCHIETO : Noccioleto.
NONEE… : Conferma di una negazione; quasi a dire “No, non insistere ancora”.
NORO : Genero (anche GHIENORO).
NOVA : Notizia.
'NTENGOLATO : Unto (v. anche 'ONTOLATO).
'NTICCHIA : Un po' (v. anche FRICCIOLO, ETO, OGNA).
‘NTIGNA’ : Insistere, incaponirsi, (anche INTIGNA').
'NTIRICHITO : Disseccato, intirizzito. Rimanere sbalordito, sorpreso (v. INTIRICHITO).
'NTISI : Intesi, capiti (v. ANDENNA).
'NTISICHITO : Rinseccolito.
'NTRALUCCA' : Barcollare; essere instabili (v. ANTRALUCCA’).
'NTRAPPAJA' - 'NTRAPPAJATO : Confondere, confuso (v. ANTRAPPAJA' – INTRAPPAJASSE).
'NTRATANTO : Intanto, frattanto.
‘NTRICASSE : Intricarsi.
'NTRONATO : Intontito, stordito, incrinato (in senso figurato: stupido, minato nella salute) (v. INTRONATO).
'NTRUJASSE : Sporcarsi (v. INTRUJASSE).
'NTRUPPAGHIRBE : Malfermo, barcollante.
‘NTURCINATO : Intrecciato, aggrovigliato (v. INTURCINATO).
'NTUSATO : Ammaccato (anche ANTUSO o INTUSATO).
NU' JE LA CACCIO : Non ce la faccio.
NUN ME ME VENE : Non mi va, non ne ho voglia.
'NZEGNATO : Insegnato.
'NZIFONA' : Coitare.
'NZUATTATO : Tanto sporco.
'NZUGA' : Istigare.
OCCHIATICCIO : Malocchio.
OGNA : Unghia (un'ogna = un po') (v. anche ETO, FRICCIOLO, 'NTICCHIA).
OJI : Oggi.
OMMASTO : Basto, sella.
OMMINO : Uomo.
OMPICCIONE : Ombelico (v. anche UMPICCIONE) usato, a volte, anche il termine 'MBELLICO.
ONNASPO - 'NNASPO : Raspo d'uva, grappolo (v. anche RACICIO e ROMPAZZO).
ONNESCO : Boccino (v. anche NESCO).
ONTO : Lardo.
ONTOLATO : Unto (v. anche 'NTENGOLATO).
OPO : Lupo.
OPRA : Persone assunte per un lavoro. (ajo scerdo ill'opra = ho trovato gli operai).
OR DE NOTTE : Identificabile con l'Ave Maria, il suono delle campane all'imbrunire. Usato anche come termine di paragone (te faccio comme 'n or de notte = te ne do così tante da farti nero). (Vedi anche "CARCALLASINO").
ORGANETTA : Fisarmonica.
ORLOGGIO : Orologio. “Ill’orloggio ‘i pponte”
OTO : Sporco, sudiciume (v. LOTO).
OTOSO : Sporco, agg.
PACCHIAROTTO : Pienotto, grassottello.
PACÈNZA : Pazienza.
PAINO (fare il _) : Ostentare, esibire.
PAJARICCIO : Materasso riempito di foglie di granturco e paglia.
PAJARO : Fienile, cumulo di fieno o paglia.
PAJAROZZA : Pagliaio di dimensioni ridotte (1,5 m. circa).
PALANCA : Tavola di legno non pregiato, usata in edilizia come piano d'appoggio.
PALLOZZO : Bozzo, rigonfiamento.
PALLUCCOLA : Piccola palla, bacca di cipresso.
PAMPAJOLE : Briciole di legno o foglie secche.
PAMPARITI : Piccoli dolcetti fatti in casa.
PANACCA : Forte colpo a mano aperta.
PANNATAIO : Nicchia, scaffale a muro (nelle vecchie case, prive di acqua corrente, rappresentava lo spazio destinato a contenere una brocca).
PANNINARO : Colui che vende stoffe.
PANTÀSIMA : Fantasma.
PANUNTELLA : Azione dinamica del fare il PANUNTO (FACEMO LA PANUNTELLA? = STROFINIAMO IL PANE SUL LARDO? … che si appendeva al camino).
PANUNTO – PANONTO : Pane unto (strofinato, ad esempio, al lardo di maiale che lo rende grasso).
PANTANICCIO (o PANTANICCHIO) : Pantano, area ricca di pozzanghere.
PAPARME : A terra sdraiato (Si sbatte i' ccapo, aremane jò a ppaparme = se batte la testa resta steso in terra).
PA-PPA-RA-PA’ : Sillabe non pronunciate, ma fischiate. Quattro note sinonimo di esagerazione; quando qualcuno la dice proprio grossa.
PAPPOLA : Frottola, storiella inventata per burla o per vanteria.
PARAVANTI - PARANNANZI : Grembiule da cucina o per artigiani.
PARA : Piccola diga (para de patalocco).
PARO : Paio - Sembro (che te paro? = cosa ti sembro?).
PARO E CEPRO (SCEPRO) : Pari e dispari.
PASSONE - PASSUNE : Grosso palo da recinzione.
PASTASCIUCCA : Pasta asciutta.
PASTECHE : Pasticche.
PÀSTINO : Miscuglio, impasto di letame (anche di sterco umano!) e paglia, utilizzato come concime. A Soriano, c'è un Vicolo dei Pastini, ove anticamente avveniva il "butto" dei rifiuti e dei bisogni fisiologici, che poi venivano appunto utilizzati come fertilizzante.
PATACCA : Macchia, bella donna.
PATALOCCO : Stupido; membro maschile.
PATE : Padre (v. anche TATA).
PATI' : Soffrire; (patisciva = soffriva).
PATOLLO : Persona di fisico pesante, torpido.
PATRÍCCIA : Giaciglio miserevole.
PATUNIA : Paura (v. anche LAPPEDUNIA).
PATURNIE : Nervosismo (lassime perda c’haio certe paturnie… = lasciami stare, ho certi nervi…).
PECORARECCIA : Ovile.
PEJO : Peggio.
PELA : Scotta, brucia.
PELA' : Sbucciare, scottare.
PELOSELLA : Erba campestre, profumata e commestibile, ricoperta di peluria.
PÈNNA : Pendere (a settembre i'll'uva è fatta e la fico penne) - A PENNA = Penzoloni.
PENNATAJA : Erba selvatica infestante che nasce sui muri: paretaria.
PENNAZZE : Ciglia e/o sopracciglia.
PENNENTI : Orecchini.
PENNINELLA : Gioco dei bambini, consistente nel fare centro con la penna (munita di pennino) in un punto del preciso del poggiapiedi del banco di scuola.
PENNOLONE : Nel senso di persona alta e dinoccolata.
PENNULUNI : Penzoloni. (ch'i ccarzuni pennuluni = con i pantaloni penzoloni) (v. anche CUJA LENTA).
PEPARELLA : Erba selvatica commestibile, usata come condimento.
PEPE PAPA RENTO CASA : Gioco con le biglie per bambini.
PEPERONE : Fungo non commestibile di colore bianco sporco.
PERA : Pera (pl. le pera), in senso figurato le botte.
PERCOSSO : Stupito, sbalordito (remase percosso = rimase sbalordito o colpito).
PERCOTA : Stupire, sbalordire (me percotette = rimasi stupito).
PERSICHE : Pesche.
PERSORA o PERSOJA : Catino di coccio.
PERTICA : Bastone flessibile utilizzato per battere le piante e far cadere i frutti.
PESTATORO : Pestello (del mortaio).
PETALINO - PEDALINO : Calzino (M'ha ditto petalino oppure m'ha ditto zella = Sono stato sfortunato ).
PETETE : Puzze (nel "buco delle petete" c'erano dei gabinetti pubblici all'aperto).
PETTINICCHIA : Fungo.
PIAGNA : Piangere.
PIAGNITOIO : Casi pietosi.
PIANETTELLO : Ripiano di terra alla sommità di una salita.
PIANTA' : Smettere (l'hai da piantà = dei farla finita).
PIANTA' I'CCHJÒO : Fare la Cresima.
PIATTELLA : Parti meno nobili del maiale (interiora, muso, orecchie) cotte insieme alla porchetta in apposito recipiente (v. anche ACQUETTA).
PIATTERIA : Cristalliera, mobile che contiene piatti e stoviglie.
PIATTOLA : Parassita (rivolti a una persona fastidiosa e insistente "s'ì comme 'na piattola).
PICA : Ghiandaia (uccello).
PICCASURCI : Pungitopo.
PICCICHIRI : Chicchi di grandine.
PICCININO : Dito piccolo del piede.
PICCO : Senza soldi (Sto a'ppicco = Sono senza soldi).
PICÊLLO : Pedicello, foruncolo.
PICIA : Organo sessuale femminile (Fare a picia = coitare).
PICIANGULI : Brandelli penzolanti.
PICÍNO : Punta estrema di un sacco, angolino.
PICIO LENTO : Persona oltremodo tranquilla.
PICIOCCO : Picciolo; organo sessuale maschile.
PIDOCCHIO AREFATTO : Arrichito; che ostenta questo suo nouvo stato.
PIEI : Piedi.
PIEI DURGI : Usato nei confronti di chi cammina con sofferenza (e ccammina bbene… che c’hai i ppiei durgi?)
PIENARA : Alluvione.
PIETRUCCOLA : Sampietrino.
PIGNATTO - PIGNATTA : Pentola.
PIJA' : Prendere.
PIJA' CHI'LLOMBRELLA : espressione figurata usata la mattina delle Ceneri quando, trovata una persona addormentata dopo una notte di balli, si apriva l'ombrello su di essa, prima di svegliarla e costringerla a pagare la colazione).
PIJA’ LA SEGA A GGIRO : Girarci intorno, essere inconcludenti (menare il can per l’aia).
PIJA' 'N COLLO : Prendere in braccio (T'aio da pijà 'n collo? = Devo prenderti in braccio?).
PILOTTO : Fastidio (non me dissi i'ppilotto = non mi assillare).
PILOZZA : Recipiente ove porre gli alimenti dei maiali, scavato nella pietra (v. anche TROCCOLO).
PILUCCO : Peletto; anche di persona con una capigliatura rada e ispida.
PIO : Bastoncino, pezzetto di legno.
PIOTO : Lento nell'agire, tardo di mente.
PIOTO PIOTO : Andatura lenta, comportamento della persona tranquilla, flemmatica.
PIPINETO : Dicesi di un gruppo di persone vocianti.
PIRICOCOLO : Albicocco (albero); PIRICOCULI (i frutti).
PIROLE : Pillole.
PITALE : Vaso da notte.
PITINATA : Schioccare di dita, colpo portato col dito medio rilasciato di colpo dal pollice.
PITOLA’ : Girare su se stessi.
PITOLOZZO : Piccola trottola di legno, picchio, a corda.
PITTURINA (fare a _) : Beccarsi in modo dispettoso e quasi infantile (hanno fatto a pitturina = si sono beccati).
PITUÈRIE : Chiacchiere a vuoto.
PIUJCCICA : Pioviggina (v. FRILLICHICCHIA).
PIZZARULLI : Ghiaccioli.
POJELLO : Manciata (es. di nocciole) a due mani.
POJO : Poggio (I' ggiorn'i'ppojo = Il lunedì dell'Angelo).
POLACCA : Blusa femminile.
POLE : Può.
POLLANDRELLI - POLANDRELLI : Bacche selvatiche commestibili, simili alle nespole, ma più piccole.
POLLEDRA : Vescica (pl. le polledra).
PORCARECCIA : Porcilaia.
PORCO : Maiale, sudicio.
PORETTA ANNUI : Poveri noi.
PORETTELLO : Poveraccio.
PORNELLO : Susino (albero) PORNELLA = Susine (frutta).
PORO - PURITTI : Povero - poveretti (Poro cristiano = Pover'uomo).
POSTALE : Autobus (vedi CORRIERA).
POZZA - POZZI : Che tu possa (che te pozzi pijà 'n gorbo = che ti venga un accidente).
PREME : Interessare (me preme = mi interessa).
PRESA : Palpata di natiche.
PRESCIA : Fretta.
PRETE : Sagoma in legno dove si inseriva lo scaldaletto.
PRICISSIONE - PRETISSIONE - PRITISSIONE : Processione.
PRICURA' : Riordinare, accudire, rassettare (la casa) - Pricurà le bestie = Accudire gli animali.
PRIMURA : Urgenza, premura.
PROENNA : Composto per cavalli, di fave e biada, "servito" in un sacchetto legato al muso dell'animale (v. MUSETTA).
PROÌBITO : Cattivo, ingovernabile (v. anche TRISTO).
PROVA : Bordo (es. la prova della via = la cunetta)
PRUZZA : Prurito (v. anche SURCICO e ROELLO).
PUCCIA : Bambola.
PUCÍNO : Pulcino, anche di frutta troppo matura (la pesca c'ha i'ppucino), strafatta.
PUGNASACCO : La spiga selvatica (FORASACCO v.) capitata in un sacco.
PULISCENZA : Pace, modo di dire di smettere un gioco di bambini.
PUMMEDORO : Pomodoro.
PUMMIDURITTI (a boccolo) : Piccoli pomodori a grappolo da consumare in inverno.
PUNTICCIUNI : Colpi dati con le nocche delle dita.
PUPPIDA : Upupa.
PÛRA : Paura (veni ccà, n’issi pura = avvicinati, non temere).
PURCHITTI : Maialini.
PURCHITTI DE SANT'ANTOGNO : Insetti che si appallottolano se impauruti.
PURTICALLO - PURTIGALLO : Arancia.
PUTIVA : Poteva.
PUZZOLOSO : Sporcaccione (anche dispettoso).
QUARANTOTTO : Conteggio delle carte sparigliate nel gioco della scopa.
QUARTARONE : Grosso recipiente da cantina.
QUARTERIA : Terreno concesso in conduzione agricola ad un colono, cui spettava 1/4 dei raccolti.
QUÈLLE : Nulla, niente, nessuna cosa.
QUESSO? : Quale?
QUESTORO : Costoro.
QUINATO/A : Cognato, a.
RABBIA : Invidia (C'hai rabbia? Rusica la vidabbia).
RACCHINICHITO : Rachitico.
RACCIURCINATO : Raffazzonato, alla meglio, rattoppato.
RACICIO : Racemio, parte di un grappolo d'uva (v. anche ONNASPO e ROMPAZZO).
RAFACANE : Ingordo, avido, insaziabile.
RAFFICA' : Graffiare.
RAFFICO : Graffio.
RAMAJA : Ramoscello secco.
RAMICCIA : Gramigna.
RAMINA : Schiumarola.
RANCICA' : Grattare.
RANCICHETTO : Striscetta di cotenna (avere il rancichetto = sentire il rancido alla gola per il cibo grasso).
RANCICHILLI : Plurale di RANCICHETTO.
RANCICO – RANCIO : Rancido, stantio.
RANCURICCHIASSE : Piegarsi, farsi piccolo (v. ANCURICCHIASSE o RINGURICCHIASSE).
RAPAZZOLA : Cuccetta di capanna.
RASCHIAMACHINE : Attrezzo da cucina in ferro, per pulire il piano della madia dai residui della pasta del pane.
RASOLETTO : Piccolo spiazzo di terreno.
RATTA : Rete, peritoneo del suino, con cui si fasciano i fegatelli da cuocere "de lo spido".
RATTATUJA : Confusione, ressa.
RAZZICARELLA – RUSICARELLA : Dispetti, ripicche, infantili.
RECULE : Cade e non si recupera (usato, ad esempio, per gli alimenti ATTENTE CO' LA FARINA CHE RECULE).
REGAZZO/A : Fidanzato, a.
REGGIA : Reggere, prestare (te l'ajo dato a reggia = te l'ho solo prestato).
REGGIA CECIO : Sinonimo di riservatezza, saper mantenere un segreto (nun reggi cecio = sei un chiacchierone).
REGNA : Covone di grano.
RENTA' - RENDA' : Entrare (Rentà rento = entrar dentro).
REPARBASSE : Non osare, aver timore (v. AREPARBASSE).
RIA : Ridere.
RICCOJA - RICCOSSA : Raccogliere, raccolta.
RICHIÈA o RECHIÈA : Controllare, ispezionare (specie i confini dei campi).
RIECCO - ARIECCO : Di nuovo.
RIMPINICASSE : Arrampicarsi.
RINNACCIO : Rammendo, accia di filo.
RINVICIDA' - RINVISCIDA' : Resuscitare.
RISPARAMBIO : Risparmio.
RIVOLO : Piccolo topo montano, tasso.
RIZZA' : Alzare, alzarsi dal letto.
RIZZASSE - RIZZITE : Alzarsi - Alzati! (da terra, dal letto).
ROCCHIO : Pezzo di carne, salsiccia; anche pezzo cilindrico di legno.
ROELLO : Prurito. Quando si manifesta in modo naturale (v. PRUZZA e SURCICO).
ROMPAZZO o RAMPAZZO : Grappolo d'uva (v. anche ONNASPO e RACICIO).
RONCETTO : Roncoletta.
RONCIO : Roncola.
RÔNNA : Grinta, cipiglio.
ROPPA : Rompere (nu ruppissi … = non rompere …); v. anche SPASCIA'.
ROSCIO/A : Rosso/a.
ROSORE : Irritazione cutanea che provoca prurito (ROELLO).
ROSORICCHIO - ROSOLICCHIO : Troppo cotto - di un soffritto bruciacchiato (leva la tigama, nu lo facissi rosoricchio = togli la padella, non farlo abbrustolire).
RÔTTE - ROTTEZZIA : Grotta , grottaccia, antro, caverna.
RUGHE : Processionarie.
RUÌNA : Rovina.
RÛJ : Rovi.
RUPI' - RUPERTO : Aprire, aperto (rupette = aprì).
RUSCINA : Persona sporca e trasandata ("nun facissi la ruscina = cura un po' meglio te stessa").
RUSICA' : Rosicare, rodersi dall'invidia (v. RABBIA) - RUSICA! Usato nei confronti dell'invidioso. L’imperativo viene accompagnato da un gesto con le unghie, passate avanti e indietro sui denti.
RUSICHINO : Parte cartilaginosa del prosciutto.
RUSPA' - RUSPO : Ripulire - Gioco di carte (andare a ruspo = cercare qualcosa rimasta dopo il raccolto).
RUZZA : Ruggine.
RUZZACCHIOTTO : Individuo un po' sempliciotto, ma soprattutto rozzo e greve.
RUZZOLA : Oggetto circolare.
SACCIO : So, conosco. Lo SAPARAJO? = Lo saprò? - Vieni a dirlo a me?. (Saccio un unnio = so dov'è un nido).
SACCOCCIA : Tasca.
SACCUNI : Confraternita dei … (che in saio bianco trasportano la bara con il Cristo nella processione del venerdì santo).
SAMPISTERNO : Santo di comodo, "virtuale", con cui prendersela nei momenti di rabbia (mannaggia sampisterno).
SAPPA - SAPPONE : Zappa, zappone.
SARACA : Getto recente di rovo da more, tenero e commestibile.
SARAPOLLI : Varietà di erba commestibile.
SARDAFOSSI : Geometra.
SARGE - SARGIO : Salice.
SARTORE - SARTORA : Sarto, sarta.
SARVATICO : Selvatico.
SARVIETTA : Tovagliolo.
SASSICHETO : Strada o fondo sassoso.
SATOLLO : Sazio.
SBAJA' : Sbagliare.
SBATIZZA’ : Affannarsi a fare o cercare qualcosa.
SBÉOLA' : Belare (anche di persona blaterante).
SBILLICASSE : Sbellicarsi.
SBRILLOCCHI : Brillanti, gioielli (v. anche BRILLOCCHI).
SBRILLUCCICA' : Brillare.
SBROCCARE : Andare fuori di testa.
SBUCA’ : Bucare, forare.
SBURRA' : Eiaculare.
SCAFARE : Togliere dai baccelli.
SCAFATO (S’è _) : S'è fatto furbo.
SCAFI : Fave.
SCALLALETTO : Scaldaletto.
SCALLINO : Recipiente che contiene carboni accesi, per riscaldarsi.
SCALUNI : Gradini (li scaluni 'i'ddomo = i gradini del duomo).
SCANGOSCIO : Cosa mal ridotta, sbilenca.
SCAPOCOLLO : Dirupo.
SCAPPA' : Uscire (luvì scapp'i'zzole= guarda un po', esce il sole).
SCARVUJA’ : Scompigliare, sconvolgere (v. anche CARAVUJA').
SCARCA' ILL'UNNII : Togliere i nidi.
SCARCIOFULI - SCARCIOFULITTI : Carciofi - Carciofini.
SCARDAONE : Scarabeo.
SCARGIA : Scorza.
SCARTARELLA : Gioco che i ragazzi fanno con il pallone (uno contro tutti, in un dribbling continuo).
SCASA' : Traslocare; anche mettere le dita nel naso.
SCATARRA’ : Espettorare.
SCEGNA - SCENTO : Scendere. Sceso.
SCENTA : Discesa.
SCEPRO : Dispari (v. anche CEPRO).
SCÈSCITO : Disordine materiale.
SCHIFETTO : Recipiente piano con bordi, ricavato nel legno.
SCHIOPPO : Fucile.
SCIACCUJA' : Confondere (SCIACCUJA' i'ccapo = confondere la mente; SCIACCUJOTTO = confuso).
SCIALA' : Godere, divertirsi, provare soddisfazione.
SCIALITO : Alimento oramai insipido, che ha perso la sapidità di cui una volta era ricco.
SCIALOJA : Godimento.
SCIALUGARE : Lasciare il nido, la casa per la prima volta (farsi grandi).
SCIALUGHINO : Uccello al primo volo.
SCIAMPERLE : Ciabatte.
SCIASCIA : Varietà di peperino vulcanico rosato, tipico dei territori del Cimino.
SCINICASSE : Faticare, stancarsi esageratamente (SCINICATO = sciancato, malfermo) (me so' scinicato pe' carrejà le legna = mi sono sfinito per trasportare la legna).
SCINTILENE : Lampada ad acetilene.
SCIOJA : Sciogliere (ji s’è sciord’i’ccorpo = ha avuto problemi intestinali).
SCIOMMOLA' - SCIMULA' : Parziale prosciugarsi (di terreno, oggetti umidi).
SCIORNA : Persona estremamente trascurata.
SCIORTA - SCIORDA : Diarrea.
SCIUTTASSE : Asciugarsi, es. ha patito la sciutta (di frutto disidratato, coltivato in un "SECCARECCIO").
SCOCCODEJA’ : Parlare con insistenza, sguaiatamente.
SCÔLA : Colapasta.
SCOLE ARDE : Scuole superiori.
SCONOCCHIATO : Dissestato (di cosa, mobile) (di persona : l'ajo sconocchiato = l'ho picchiato per bene).
SCOPA : Ginestra dei carbonai (lat. cytisus scoparius).
SCOPETO : Luogo invaso dalle ginestre dei carbonai.
SCOPPIA' : Battere (le mano = le mani).
SCOPPOLARELLE : Tipo di susine (Le pornella scoppolarelle).
SCORROMPISE : Guastarsi (col tempo).
SCORZO : Scalzo (Ch'i'ppiej scurzi = A piedi scalzi).
SCOTA : Scuotere. (Scutiva = Scuoteva).
SCROCCHIO : Scroscio, rumore (es. m'hanno scrocchiato ill'ossa).
SCRUÈJO : Capriccioso, schifiltoso, stravagante.
SCUCCHIA : Mento prominente.
SCUJASSE : Sbellicarsi, sfiancarsi (me so' scujato p'i' rrja = mi sono sbellicato dalle risate; me so' scujato pe' pportallo su = mi sono sfiancato per portarlo su)
SCURI : Sportelli di una finestra.
SCUROSO : Chi soffre il solletico (SURCICO).
SCURREJA' : Fare venti, peti rumorosi.
SCUSCIATA : Chiassata.
SDEMOGNA : Disgelare.
SDEGNATO : Irritato, degenerato (es. trasformazione maligna di un foruncolo).
SDILUNGASSE : Allungarsi, distendersi.
SDILUVIA : Piove abbondantemente.
SDIVIGNA' : Vendemmiare (anche VELEGNA').
SÊA : Sedia, verbo sedere (es. mettise a sea = mettersi seduti).
SECCARECCIA : Aridità.
SECCARECCIO : Terreno arido.
SECCATORO : Essiccatoio.
SEDOIO - SEDITORE : Sedile.
SELLERO : Sedano. (Usato a volte nei confronti di una persona un po' imbranata).
SEMENZA : Chiodino.
SENTO : Segnato (un punteggio, una nota, un goal).
SENZALE : Mediatore; organizzatore di incontri d’affari.
SERTA : Ghirlanda, serto (detto di agli e cipolle).
SETOLA : Crine guida o pilota, utilizzato dal calzolaio per trascinare lo spago nei fori della tomaia.
SÉRVA : Selva.
SFRAGNA : Spremere, schiacciare.
SFRATAZZO : Frattazzo, grande spatola per intonaci (v. anche AMERICANA).
SFRIZZOLI - SFRICCIOLI - FRICCIULI : Ciccioli.
SGANASSUNI : Colpi dati in faccia.
SGNOLA' : Miagolare (anche GNAOLA').
SGOMMARELLO : Mestolo (v. MESCOLA).
SGRACIOLATURA : Scorticatura, abrasione.
SGRAMAJI : Ricami, decorazioni.
SGRAVA' : Partorire.
SGRIGNATA : Raggio di sole che fa capolino dalle nuvole.
SGUILLA' : Slittare.
SGUINCIO : Obliquo, (l’ajo preso de sguincio = l’ho colpito di striscio).
SGUINCIUNI : Scroscio, obliquo, di pioggia.
SI FREGATO… : Che ti prenda…
SI MMAI CHE SI’ : Nel caso che, caso mai.
SI SI’ BBONO…COMMATTICE TU : Se sei capace… fallo tu.
SI TANT'E' - SI TANT'ENE : Se è così, tant'è.
SIMIA : Scimmia.
SIMINA : Semina.
SINALE : Grembiule domestico (v. anche ZINALE).
SINALONE : Grembiule scolastico (v. anche ZINALONE).
SINDINELLA : Sentinella, controllore (stì de sindinella? = vigili?).
SITO : Luogo.
SLECIO : Insignificante, insipido (v. LIECIO).
SMANEJA' : Rimestare, maneggiare (v. anche SMUCINA').
SMARINO : Rosmarino.
SMETTA : Smettere.
SMICCIA' : Sbirciare, adocchiare.
SMONNOLA’ : Pulire (col monnolo) i vecchi forni a legna.
SMUCINA' : Rovistare (anche AREFUCINA' o AREMUCINA').
SOATTA : Colpo molto forte e veloce (es. diretto di un pugile; tiro di un calciatore).
SOCCIO : Contadino (alle dipendenze) - v. anche VILLANO.
SOFFREO : Avanzo, rimasuglio.
SOMA : Carico (di un asino).
SORCA 'NTENTA : Impomatato, unto.
SORRAGA : Aringa.
SORVA : Frutto. Bòtte (va' vija sinnò so' sorva = vattene altrimenti le prendi).
SPANACCA' : Schiaffeggiare (dare le PANACCHE).
SPANNA - SPASO : Spandere - sparso.
SPANNULI' : Sbadigliare.
SPARAMBIO - SPARAGNO : Risparmio.
SPARGIO : Asparago.
SPARRUCA' : Disperdere, mettere fuori posto (chi ammontona e chi sparruca = chi risparmia e chi sperpera).
SPARTA : Dividere. (Se spartiscino = Si dividono).
SPASCIA' : Sfasciare, rompere; v. anche ROPPA.
SPEGNA - SPENTO : Spingere, spinto.
SPÈNNA : Spendere (v. anche SPRAGNA).
SPERDIA’ : Bestemmiare.
SPIANATORA : Tavola per lavorare la pasta.
SPICCIASTALLE : Veterinario.
SPICCICHERA' : Grandinare.
SPICIOCCA' : Staccare (es. i "pummiduritti a boccolo", conservati per l'inverno).
SPINICASSE : Sporgersi.
SPINICO : Altalena.
SPINOSA : Istrice.
SPITO o SPIDO : Spiedo.
SPONNA’ : Sfondare.
SPONNATO : Sfondato – molto fortunato.
SPORDO : Spogliato, nudo.
SPORDO (S’è _) : Si è tolto l'abito talare.
SPRAGNA : Spendere (v. anche SPENNA).
SPULINA' : Ripulire l'arredo (riferito soprattuto alle pulizie straordinarie di Pasqua), vincere al gioco (es. l'ajo spulinato).
SPUNGICA' : Pungere, punzecchiare.
SPUNTA : E’ inacidito (tipico del vino che prende aria), ma rivolto anche a qualche zitella particolarmente acida.
SPURTUNA : Sfortuna (so' SPURTUNATO comm'i'ccani dill'acchiesa = ho la stessa fortuna dei cani che entrano in chiesa).
SQUIZZAMUSO : Tagliolini in brodo.
SQUIZZARELLO : Gioco che facevano i ragazzi tirandosi l'acqua.
STACCIÛNI : Residui della lavorazione della canapa o di altri vegetali.
STAFFA : Attrezzo del calzolaio, utilizzato per poggiare le calzature da confezionare.
STAGNARO - STAGNINO : Idraulico.
STEGNA - STENTO : Spegnere, spento (es. Stingi i'llume stì! = Spegni quel lume!).
STÉNA : Steccato.
STENNA : Stendere (me fai stenna le zampe = mi farai morire).
STIGNA' : Togliere (un vizio, una cattiva abitudine) es. t'ajo da stignà.
STILOSO : Di bella fattezza, sportivo (che machina stilosa… = che auto sportiva…)
STORZA' : Balzare, trasalire (M'ai fatto storzà = Mi hai fatto sobbalzare dalla paura).
STORZO : Scatto, sobbalzo
STRACCALI : Bretelle.
STRACCASSE - STRACCO : Stancarsi, stanco.
STRAGNERO : Straniero.
STRASCINA' - STRASCINUNI : Trascinare - Trascinandosi (anche A STRASCINO = Al traino).
STREGNA : Stringere.
STRIFOLACCIA : Strofinaccio da cucina.
STRIPPASORRAGHE : Secco, estremamente magro.
STRIULO - STRIVOLO : Strigolo (Silene inflata); erba spontanea primaverile, dal sapore simile agli spinaci.
STROLIGO - STROLICO : Indovino, astrologo.
STROZZAPRETI : Tipo di pasta fatta in casa.
STRUFFAJE : Impicci, cose superflue o inutili (v. anche GHIACCULI e ZARAVATTULI).
STRUFOLI : Dolce tipico del carnevale simile alle castagnole.
STRUPPIO : Storpio.
STUCCATO : Spezzato, staccato.
STUCCO : Sinonimo di approssimazione (facemo a stucco = facciamo a occhio).
STURA' : Accendere (i ffurminanti), stappare (i' llavandino).
STUTERA' : Togliere i tuteri del mais dalle foglie che li avvolgono.
SUNE : Su (veni sune? = sali?).
SUBBIA : Attrezzo arcuato usato dal calzolaio per forare la suola.
SUCCHIO : Varietà arbustiva di acero campestre.
SUDDIZIONE : Soggezione
SUGAMELLI : Fiori, tipo campanule, che venivano succhiati.
SUGA' : Succhiare.
SUGACICHE : Fumatore esasperato che, aiutandosi con uno spillo, fumava fino a scottarsi le labbra.
SUGAETO : Bambino che si ciuccia il dito.
SUGASUBBIE : Secco, allampanato, che "SUGA" le "SUBBIE".
SULI : Soli (s. Solo) (ERIMA dui suli - Eravamo solamente in due).
SULINA (alla _) : Al sole. (I vvecchi a piazza stanno alla sulina = I vecchi in piazza si mettono al sole).
SUPPELLI' - SUPPECCHI' - SUPPESTI' : Su per di lì, su per di qua - Lassù.
SURCICO : Solletico provocato (fare il SURCICO = fare il solletico)
SURIANO : Soriano.
SUSTACCHINA : Travetto di legno.
SUTRINA : Frittella con acqua e farina.
SVERDO COMME LA PORVERE : Veloce mentalmente, intiutivo.
SVORCHIA' : Togliere le nocciole dalla parte verde che le avvolge (v. VORCHIO).
TACCHIA - TACCHIETTA : Pezzetti di legno per accendere il fuoco (vedi anche APPICCIUME).
TADDÈO : Te Deum.
TARROCCA' : Rimproverare.
TASTA : Spicchio per la verifica della maturita dell'anguria.
TATA : Padre, papà (v. anche PATE).
TE POZZA PIJA' 'N TRONO/GORBO! : Che ti prenda un colpo!
TEMPERANZA : Conseguenza di una pioggia eccessiva (es. osservando una sorgente intorbidita "ha fatto temperanza").
TENE' CONTO : Considerare.
TERRA PIANO : Piano terra (sto accasato a terra piano = abito a pian terreno).
TERZILE : Telo dove si appoggiavano le pagnotte pronte per essere cotte; era anche usato per tenere separati i pani.
TÉSTO - TÉSTO STI' - TISTI : Questo, questo qui, questi.
TIÈLLA : Teglia.
TIGAMA : Tegame.
TIGNA : Tenacia, insistenza, testardaggine.
TIGNOSO : Caparbio, cocciuto.
TINGOLO (1-2-3) : Filastrocca dei bambini che giocavano a 'NGUATTARELLA.
TIPPE TOPPE : Toppa gommosa utilizzata per riparare le camere d'aria delle biciclette.
TISTIMOGNO : Testimonio.
TÍTOLO : Bambino.
TOA' - TOASSE : Piegare, piegarsi (nun me pozzo toà = non posso piegarmi).
TOCCA : Bisogna.
TOCCIO : Collo della bottiglia.
TORSO : Stupido, ingenuo.
TOTERO : Totolo (interno della pannocchia).
TOTOLA' - TOTOLONE : Brontolare, brontolone.
TRABBACCHINO : Baldacchino.
TRAFUGO (DE _) : Di nascosto.
TRAVAJO : Lavoro.
TRICCHE E TRACCHE : Tavola in legno con due perni metallici che veniva utilizzata dal venerdì Santo alla Pasqua di Resurrezione. Sostituiva il suono delle campane, per definizione "legate". Un esemplare è ancora conservato nella Chiesa di S. Agostino.
TRINCETTO : Lungo coltello del calzolaio.
TRIPPITINO : Piccolo tre-piedi.
TRISTO : Cattivo, v. anche PROÌBITO (Accitefa quanto sì tristo = perbacco quanto sei cattivo) .
TROCCOLO : Recipiente, ricavato da un tronco d'albero, dove si versa il cibo dei maiali (v. PILOZZA).
TROJA : Scrofa.
TROMBA’ : Fare sesso.
TRONA' - TRONO : Tuonare, tuono.
TROSCIA : Sbocco d'acqua verso il basso.
TROVA' LOCO : Tranquillizzarsi (nun trova loco i'ffijo stì = quel bambino è molto irrequieto).
TROVO : Trovato (l’ajo trovo io = l’ho trovato io).
TRUZZOLA' - TRUZZOLARE : Ruzzolare.
TUCINO : Beccuccio della brocca per l'acqua.
TU'MMEZZO - DU'MMEZZO : Nel mezzo.
TURVIO : Torbido.
TUSSI' (CUSSI') : Così, in questo modo (anche ACCUSSI' - ATTUSSI').
UA : Uva.
UFFA : Esclamazione annoiata.
UMPICCIONE : Ombelico (v. anche OMPICCIONE).
UNCENZO : Cipresso.
UNNICE : Nido ove depone la gallina.
UNNÌO : Nido (d'uccello, d'animale di piccola taglia).
URDIMO : Ultimo (l'ultima viene detto… "la l'urdima").
URZA : Ronzio.
URZINO : Ronzino.
VACCARECCIA : Zona adibita all'allevamento dei bovini.
VACCHITELLA : Vitella.
VACCIO : Gozzo (la gallina 'ngorda j'è crepato i'vvaccio = alla gallina ingorda è scoppiato il gozzo).
VAGO : Chicco (d'uva), al plurale può anche indicare dei colpi (j'ajo dato du vaga = gli ho dato due colpi).
VAJATA : Russola (fungo).
VAJO : Vado (1^ pers. sing. - ind. pres. - verbo andare).
VELEGNA' : Vendemmiare (v. anche SDIVIGNA')
VÈNE : Venire, andare, aver voglia (nun me ne vène = non mi va).
VENNA - VENNE : Vendere.
VERTE : Bisaccia da spalla o basto leggero.
VESCÓO : Vescovo.
VETTINA : Recipiente per olio (v. anche BITTINA).
VIARELLA : Stradella di campagna, sentiero.
VIA ROMANA : Strada maestra (nome comune).
VICCHIÛNI : Vecchioni. Ma soprattutto per indicare il loro ricovero: gerontocomio).
VILLAMPORCO - VILLAMBORCO : Villano, maleducato.
VILLANO : Contadino (in proprio) – v. anche SOCCIO.
VINI' - VENETTE : Venire - Venne (Venette fatta = Riuscì).
VINTURLO - VENTURLO : Turbine.
VITABBIA : Vitalba. Pianta. I piccoli rami secchi venivano fumati.
VOJA : Voglia.
VOJOLA : Caldarrosta.
VORCHIO : Parte verde che avvolge il guscio delle nocciole.
VORICA - VORIGA : Fossa a grosso invaso per raccogliere l'acqua da irrigazione.
ZACCO : Sacco, molto (me piaci 'n zacco = mi piaci molto).
ZAMPITALICCHIO : Grillo.
ZAPPASTRELLO : Zappa a due denti, corti e non appuntiti.
ZAPPASTRO : Zappa a due denti, lunghi e appuntiti.
ZAPPITELLO : Zappa a lama corta stretta per lavori superficiali.
ZAPPONE : Grande zappa con manico poco rifinito per lavori profondi (Si jerto comm'i'mmanico di'zzappone = Sei grossolano come il manico della zappa).
ZARAVATTULI : Impicci (v. anche GHIACCULI e STRUFFAJE).
ZASSO : Sasso (i'zass 'a culetta = il sasso della cunetta: grosso masso sito in via Montecavallo).
ZELLA : Sporcizia, sudiciume; anche malasorte (m'ha ditto zella oppure m'ha ditto petalino = sono stato sfortunato).
ZINALE : Grembiule domestico (v. anche SINALE).
ZINALONE : Grembiule scolastico (v. anche SINALONE).
ZINDIMENDO : Sentimento (me so' fatto pijà d'i'zindimendo = mi sono lasciato prendere dall'emozione).
ZINNA : Mammella.
ZIRO : Recipiente per bucato con cenere e lasciva (Si llercio comm'i'llorlo i'zziro = Sei sporco come la cenere rappresa sul bordo del recipiente).
ZOMPA' : Saltare (Nu'zzompassi = Non saltare).
ZUCCAROTTO : Zuccone (v. anche CAPOCCIONE).
```

POESIE/RACCONTI:

```
NUI

Pennazza ll' ha co' Ercole e co' Ggiano;
i' zzor Achille parla d' i Rromani:
jè 'no 'mbrojo la Storia de Suriano,
' pure, ajo letto libbaruni sani!...

Ma che 'mportanza ci'à la discendenza?
I' zzito è bello ... i' ll' aria d' i' Ccimino
j'è la carezza de la Pruvidenza...
Liggera è i' ll' acqua ... generoso i' vvino!...

Nui sì, semo 'nvidiusi, chiacchiaruni,
ce sà bbono lo spasso, i' mmagnà e bbèa;
nun ce va jò la parte d' i ffrignuni.

Si quistionamo, èmo da èssa 'ntisi;
più ch' amprestà, ta nnui ce piace chjèa...
Semo fatti accussì nui zurianisi!...

ANGELO REALI

SOTT'ILL'ERGE DE S.UTIZIO

A ffresco soott'i'll'erge,verso sera,
m'affisso a rimirà Suriano mia.
Quante memorie,quanta poesia
'ste quattro case, cò la rocca fiera!...

Nun te pare 'na locca, che la schiera
d'i ppucini protegge?.... Caccio via
ogni addro sogno de la fantasia!...
guardo d'i'zole la lucente sfera

che,quann'è ì'll'ora "che volge il disio"
scegne comme 'na ruzzola de foco
sotto Monte Turello e Rocchiddio.

Me stregne i'ccore la malincunìa!
de sant'utizio vene un sono fioco:
e' i'ttocco dorge d'i'll'avemmaria.

Angelo Reali

PAPACQUA

Vecchia Papacqua mia, nun zì più quella
che, lontano, ho sognato pe' tand' anni;
dò, da ciuco, giocavo a squizzarella
e me cci' arfracicavo tutt' i ppanni

Speravo de trovatte tale e quale,
quanno, a mmerenna, cento bianche fette,
co' i ppummedori cervi, a pepe e sale,
stavin' a mmollo rendo le vaschjette.

Caravino vinniva la gazzosa;
sporgenno un luffo, p' appoggià la brocca,
'che mmunella faciva la smorfiosa ...

Si s' arenviscitasse un' ora sola,
poro nonno Peppone, sa' che bbocca
farèbbe a ved' a ffresco i' ... Coca-Cola!...

(Angelo Reali)

INVERNO
Tutta la notte pè le via ha fioccato,
Suriano è corgo sott'un gran mantello
e tira un vento freddo, 'ndiavolato:
'n c'e' caso de vede' volà un uccello

l'ggelo de stamane ha 'mbrillantato
la corona de merli d'i'ccastello;
de pizzarulli, a mazzi,ha smerlettato
le fontane da frio: je proprio bello!....

dèrèto la finestra,ch'arecamo
co'i'ffiato che s'aggela,guardo fora:
veggo i'll'arbiri 'gnudi,'ntisichiti.

de fo' gni tanto vene su un richiamo,
un trillo disperato che addolora:
so' i'll'ucelli affamati e spauriti.

(Angelo Reali)

I’ QUATTRO CANTUNI

Arevajo distì, jò pe la via
do’ le sere ‘ill’ estate, nui munelli,
giocamma i’ ggioco di’ quattro cantuni.
Chill’ occhi birbi e chi’ rriflessi prundi
currèmma svirdi pe’ cambiacce i’ pposti,
senza facce fregàe
da chi i’ ccantone s’ év’e’ procuràe
e rièmma più forte si chiduno
‘gniva a picchià chi’ ccapo addoss’ i’ mmuro.
… po’, su i’ ppiù bbello, addevendava scuro …
e trista ce paréa la voce i’ cchiamo:
“E’ or’ e’ cena … oh fi, spiccete, ‘gnamo!”

Lundano è i’ ttembo de la scena cchie!
Ma nun jè mai finito i’ ggioco stie,
chè più vai annanse e più si sbadocchiato
la ppe’ tutt’ i ccantuni.
E ill’ urdimo cantone è sempre pejo
de quell’ardro de prima,
tussì nun vidi ill’ ora de mutàe,
pure si penzi e’ curra di’ ppiricolo
de sbatta i’ ccapo forte addoss’ i’ mmuro.

Ma, a la fine, saristi ben contento
de campà ‘n pace di’ ttu cantuncello
chi’ rriflessi te se so’ ‘n po’ appannati
e la forza e’ ‘na vorda jè scemata.

Ma se fa bujo, è sera …
e, tristo e punduale, arriv’ i’ cchiamo:
“E’ giunt’ ill’ ora … oh fi’, spiccete, ‘gnamo”

(Ezio Urbani)

LA LENGUA DE LA SOCERA

Stasera mà quanno che s' ito a casa,
ho trovato l' Arinetta rento 'i letto;
sta male, cià la frèe, antro ch' annasa
e cià la panza gonfia insino i petto.

Nu' m'à potuto fa manco la cena,
me so magnato 'n bocconaccio sciucco,
che nu' me gnava jò de quant' ò pena!
eppure ciò 'na fame che 'ntralucco.

Dimane a lavorà nu' je la faccio ...
ce scrolli 'i capo mà, che nu' t sona?
vojo mannà le cose ... jo a casaccio.

Ma che stamale, quanto sì cretino!
sta male si, sta male puttanona
cià rento i' corpo 'n fiasco e più de vino!

(Pietro Fucci)

(I'ppunto de vista d'i'll'addri)

Fimmina?!...Pussa via!...Signore mio!...
jè quanto c'e de pejo su 'sta sfera;
jè sempre 'na ruìna e chi cce spera
ce sbatte i'mmuso,quand'e vero Ddio!...

Si ci'ài scialato un po', poi paghi i'ffio.
P'i'llommini è un castigo,...la galera!...
Mucci,quanno cò grazia e cò maniera
te stroliga e te 'nganda,amico mio!...

Dimme la verità,a cuscienzatua:
si nui t'i'mmonno patoscìmo i gguai,
n'e, de riffe o de raffe,corba sua?...

Trova i'mmodo de datte sempre pene.
Si nun fusse...la cosa che tu ssai
pijasse 'n gorbo a chi ji' ddice bene!...

Reali.

ROTTEZZIA

Che sso’ vvinuto a ffà, chi mmà chiamato
tramezz’ i’ mmuri de sta acchiesa antica,
do nun c’ è quèlle che che ni’ jè scarcato,
do nasce solo i’ rroto ch’ i’ ll’ urtica?

La Ternità d’ i ttempi ormai passati,
c’ era un convento e cc’ era pure ‘n zanto,
ma mmo, du’ bbuchi fonni scoperchiati
mostrino i’ ll’ ossi, pare i’ ccamposanto.

Quante capocce a bbocca spalancata!
Me guardino rienno, gialle ggialle …
Me sento da’, de bbotto ‘na strattata,
me sento spegne forte pe’ le spalle.

Rento la macchia … e, ppo’ rento ‘na rotte
longa, profonda, che nun c’ è la fine
più bbuja, ancò, d’ i’ bbujo de la notte;
le nnottole me volino vicine.

Ma mmo, ‘llajò tramezz’ i’ bbujo fonno,
vedo u’ llustrore che sse smove piano;
pare e nun pare …Si jè ‘n coso tonno
che vvedo sempre mejo, ammano ammano:

la locca ch’ i ppucini , tutti d’ oro!!
I’ ll’ ale arzate, i’ bbecco spalancato,
principino a strillà , te fanno un coro
da fatte chê dillì mezz’ intronato

Sempre a strillà ppiù forte … e mmo i’ rrumore
rentrona cupo, jè na cannonata!
La rotte trema! Me se fèrma i’ ccore,
la rotte, tutt’ un botto, s’ è scarcata!

M’ arisbejà de storzo, senza fiato,
mezzo cùto d’ i’ lletto … àvo sognato

(Domenico Patrizi)

I' LL' OROLOGGIO CH' I' CCUCULO

I' ggiocarello stì jè 'n gran tormento!
si tte fanno le f...gne, o tte va bbona,
te segna i' ll' ora e ppo', dopp' u' mmomento
scappa fora 'n ucèllo e tte c...na.

Te c...na, cumpà, tutto cuntento
cu 'na vocetta che 'gni tanto stona;
doppo cantato mucce comm' i' vvento
p' arefacce ppiù llà. Nun t' abbandona.

Jer' a ssera penzavo, moco moco,
ta la vita passata e cche vverrà ...
tante cose sbanite a ppoco a ppoco ...

Sta pe' passà 'n andranno e ... nun c' è ppiù ...
I' ll' anno novo che mme portarà?
Sorte i' ll' ucello e ccanta un ber cuccù.

(Domenico Patrizi)

‘Na vorda

M’ aricordo quann’ ero munello,
che d' i' mmonte gnavo ch’ i’ nnonno,
e adesso dì nun me pònno
che i’ mmonno s’è fatto più bello.

Io ciuco, esso vecchio,
la merenna rento la catana,
pe’ bèa ill’ acqua de la funtana
e la vita era ‘no specchio.

De ‘nguattuni de la nonna e la zia
i’ zzigaro je gnavo a cumprà,
che, poretto, lo putiva fumà
solo quanno scappamma via.

Quante bestie da soma e da tiro
c’ erino i’ ttempo lì a Soriano,
ma i’ zzomaro de nome Armano …
si ce penzo ancò suspiro.

Quanno po’ i’ nnonno morètte,
dunca tanto tempo fa,
ancò adesso nun ce posso penzà,
che bell’ epoca me se chiuètte.

Sò passati orammà troppi anni
e i’ mmonno me se fa foristiero,
m’ è rimasto solo i’ ppenziero
e me so cresciuti ill’ affanni.

Prima o po’ ce tocca da tutti
de passà da quell’ addra parte,
spero solo de fallo co’ arte
senza lascià ricordi brutti.


(ill’ aquila)


LA MANNARA

Sinente li scalini d' i' ll' acchiesa
arebbolle la folla e ffa cagnara
comm' i' ll' acqua che manna la pienara.

Sopre lo spiazzo, granne a ttesta ritta,
('no spiazzo vòto, che tte pare n' ara)
un bocco roscio, un ceppo, una mannara.

Se spanne 'n zono de campane a mmorto,
'na pritissione ècchila che vvène
assieme c' u' rrumore de catene.

S' arza 'na croce sopra 'n corpo corgo,
e te la luce che ppiù ppoco brilla
rabbia de core ta 'gni bocca strilla.

Luccica la mannara p' u' mmomento,
truzzola li scalini 'na capoccia
i' cceppo spanne sangue, goccia a goccia.

(Domenico Patrizi)


PAPACQUA DE UNA VORDA

UNA VORDA SI CHE SE SCIALAVA A PAPACQUA
C'E' SE FACIVINO LE SCOCOMMERATE
SE GIOCAVA A GAVETTUNI;
POI DE CORSA A CASA! A SINTI LI STRILLI DE LA MATE.

MO A VEDELLA A QUELLA MO, MI PIA LA MALINCUNIA
E QUASE ME CE VENE DA PIAGNE
TUTTI I RUI, LE FRASCHE,
I PALAZZO 'CAE A PEZZI,
DE LE FUNTANE NUN SE RENTA PIU'.

I MUNELLI SO CAMBIATI!!!
MO PE' GIOCHA' JE BASTA UNA PLAYSTATION,
E TUTTO E RISORDO'
MO QUANNO QUISTI DIVENTINO GRANNI
CHE C'AVRANNO DA RECCONTAIE DI FIJI
CHE GOKU E PIU' FORTE DE VEGGETA.

PORA PAPACQUA MIA CHI TA CONOSCUTO T'APPREZZA
PE L'ANDRI E SOLO UN ANTRO RUDERE A SORIANO

SPADACCINISORIANO

SUPPE'LA ROCCA

DA MUNELLO SE GIOCAVA DI PIAZZALETTO DI VICINATO,
CE' SE NVENTAVA DE TUTTO; SE JOCAVA A LA GUERRA,
LO SCHIOPETTO ERA FATTO FRECANNO CHE PEZZETTO CA' E LA'
LA TAVOLETTA DI FALEGNAME,LA MOLLETTA DE LA MATE',
ILLELASTICHITTI DI FRUTTAROLO
E PE' FINI LE SEMENZE DI CARZOLARO,
PO' VIA A CURRISE A PRESSO LAPPE I VICULITTI DE LA ROCCA.

OPPURE QUANNO NUN CERA' FANTASIA DE CURRA
SE METTEMMA DENANZI SANTUTIZIO A GIOCA' A TAPPITTI,
TANTO CERA' I BARRE VICINO, E TAPPI NUN MANCAVINO
QUANTO SE SCIALAVA!!!

MO LA ROCCA E DISSABBITATA CE' SO QUATTRO MICI,
NUN SE SENTE PIU' LA PIPINARA
A PENSACCE ME CE SENTO MALE
E ME DICO SO TEMPI PASSATI CHE NUN VENGINO PIU'
DE LA ROCCA CE' RIMASTA SOLO LA MONNEZZA.....

SPADACCINISORIANO


LA VECCHIA D'I' CCARNAJOLO

franciottola surianese d'i' quinnicesimo secolo parte 1

Lassu' d'i' mmonte,un po piu' jo d'i' ffai
sfruttanno un zeccatoro pe' ccasetta,
s'era areddutt'a vviva 'na vecchijetta,
che t'i' ppaese nu' scigniva mmai.

S'era 'nzervatichita a forz'e guai;
campava aremedianno checosetta,
in cambio de ramaja e de tacchietta.
De ggente l'ancontrava poc'assai,

e quella po',vedennola,mucciva,
facennuj le corna e li scungiuri:
buttava i'll'occhiaticcio....se ddiciva!...

Patisciva la vecchja!...e t'i'' zignore,
che nun j'ava ammannito che duluri,
chjiva solo d'accurtaje i'll'ore.
```

